あいじょう	愛情	爱情，爱慕
アイスクリーム		冰激凌
あえん	亜鉛	锌
あお	青	单词
あか	赤	红（色）
あかちゃん	赤ちゃん	婴儿
あきれる	呆れる	吃惊
アクセント		重音，音调
あくまで	飽くまで	彻底，始终，到底
あけたて	開け閉て	开关，开闭
あす	明日	明天,未来,(不久的)将来
あてな	宛名	收件人的姓名（和地址）
あてはまる	当てはまる	适用，适合
あながち		未必，不一定
あびる	浴びる	浇，淋，浴，照
あびせる	浴びせる	浇，淋
あまり	余り	...多,...余
あらし	嵐	暴风雨
あらためて	改めて	重新，再次
アラビア		阿拉伯
ありかた	在り方	应有的状况，理想的状态
あんずる	案ずる	担心，挂念
あんてい	安定	安定，稳定
あんないしょ	案内書	指南书，导游手册
い	胃	胃
いがい	意外	意外
いぎ	意義	意义,(某种行为的)价值
いきおい	勢い	气势,势头
いきかた	生き方	生活方式,生活准则
いきどおり	憤り	愤怒,愤慨
いきもの	生き物	生物,活的东西
いざというとき		紧急之时
いしき	意識	意识，自觉，觉悟
いじょう	異常	异常，反常
いためる	傷める	损坏，损伤
いたる	至る	至，至于，达到
いちいち		一（个），一（个），都
いちおう	一応	大至，大体
いちかばちか	一か八か	碰运气，听天由命
いちだん	一段	更加，越发
いっしゅん	一瞬	一瞬，瞬间
いったい	一体	究意，到底
いったい	一体	一体，同心协力
いってい	一定	一定，固定，统一
いっぽう(で)	一方	另一方面
いど	井戸	井，水井
いどう（する）	移動	移动，转移
いま	居間	起居室
いや		不，否
いやがる	嫌がる	嫌，讨厌
いらい	以来	以来，今后
いりょうはん	医療班	医务组
いれもの	入れ物	容器，器皿
いわば		可以说，说起来
いんしょう	印象	印象
うかべる	浮かべる	使．．．浮起，露出
うちがわ	内側	里面，内侧
うっかり		疏忽，漫不经心
うったえる	訴える	申诉，控诉
うでどけい	腕時計	手表
うなずく		点头，首肯
うる	得る	（接动词连用形后）能，可以
うん	運	命运，时运
えがく	描く	画，描写
えきまえ	駅前	站前
エネルギー		能，能量，精力
IC		集成电路
えんちょう	延長	延长，延伸，延长部分
おい		喂，嘿
おえる	終える	做完，结束
おお	大	大．．．，广．．．
おおう	覆う	覆盖，蒙上
おぎなう	補う	补充，补尝
おける		在
おごり		骄傲，傲慢
おちつく	落ち着く	沉着，镇静，稳定
おどり	踊り	舞蹈，跳舞
おねがい（する）	お願い	请求，恳求
おもいがけない	思いがけない	出乎意料的，意外的
おもいつく	思い付く	想出来，想起来
おもいやり	思いやり	体谅，关怀
おもさ	重さ	重量，分量
おもんずる	重んずる	注重，重视
おやすみなさい		请休息吧
およそ		大概，大约
おれ		我，俺
おん	恩	恩，恩情
おんし	恩师	恩师
か	化	...化
かい	回	...次，...回
かいがい	海外	海处，国外
かいせつ	解説	解说，说明
かいてん	回転	旋转，转动
がいぶ	外部	外部
かえって		反而，相反地
かえる	替える	替换，更换
かかわる		有关，关系到
かぎり		限度，极限
かぐ	家具	家具
かくう	架空	架空，空想
かくご	覚悟	觉悟，下决心
がくしゃ	学者	学者
かくす	隠す	遮盖
がくぶ	学部	（综合大学）学院系
かげ	影	影子，影像
かけがえ		代替的人
かけつける	駆けつける	跑到，赶到
かげもかたちもない	影も形もない	无影无踪
かけら		碎片
かげん	加減	调整，调节
カセット		盒式录音磁带
かた	型	型
かたい	硬い	硬，生硬
かたどる		模仿，仿照
かたまり	塊	块，堆，群
がち		常常，容易
がっき	学期	学期
かっと		(阳光)炽烈
かつよう（する）	活用	充分利用
カナダ		加拿大
カナヘビ		草蜥
かねつ	加熱	加热
かのう	可能	可能
かのうせい	可能性	可能性
かもしれない		也许，也未可知
かりに	仮に	假设，即使
かる	刈る	割，剪
かわす		躲开，躲闪
かん	管	管(子)，管道
かんきょう	環境	环境
かんじょう	勘定	计算，估算
かんしん	関心	关心，感兴趣
かんれん	関連	关连，相关
き	機	机械
きおん	気温	气温
ぎかい	議会	议会，国会
きかえる	着替える	换衣服
きかせる	聞かせる	使...听
きじゅん	基準	基准，标准
きづく	気付く	察觉，发现
きのう	機能	机能，功能
きばん	基板	基片，基底
きほん	基本	基本
きまり	決まり	决定，规定
きむずかしい	気むずかしい	爱挑剔，不好对付，板着面孔
きゅうしゅう	吸収	吸收，吸取
きゅうしゅう	九州	九州(地方)
きゅうそく	急速	讯速，急速
きょうか	強化	强化
きょうぎ	競技	体育比赛，竞赛
あれこれ		这个那个；种种
あれる	荒れる	狂暴，秩序混乱
あわ	泡	泡，泡沫
あわてる	慌てる	慌忙，着急
あわれ	哀れ	可怜；悲哀，凄惨
あんき	暗記	记住，背下来
アンテナ		天线
あんまり		太，过分；（后与否定语呼应）（不）怎么...；（不）太...。过分，过度
いいかげん		胡乱；恰当，适当
いいわけ	言い訳	分辨，辩解
いいん	委員	委员
いいんかい	委員会	委员会
いき	息	气息；呼吸
いく	幾	几，多少；许多
いけない		不能，不可以
いけばな	生け花	插花（艺术）
いじ	維持	维持，维护
いずみ	泉	源泉，泉
いずれ		哪个；反正，早晚
いたす		做，办；招致。表示自谦
イタリア		意大利
いちじ	一時	一时，暂时，某时
いちねん	一年	一年
いちぶ	一部	一部分
いちりんざし	一輪挿し	小花瓶
いっか	一家	一家，一家老小
いっこうに	一向に	完全，全然
いっしゅ	一種	一种，某种
いっせい	一斉	一齐；一同地
いっぱん	一般	一般，普通；相同
いつまでも		永远；任何时候
いちりゅう	一流	一流，头等
いびつ		压扁，变形；扭曲的，变形的
いまだ		尚，还；迄今
いままで	今まで	迄今，从前
いりくむ	入り組む	错综复杂
いろんな		各种各样的
いわかん	違和感	不谐调之感；感到不舒服
いわゆる		所谓的，所说的
いんさつ	印刷	印刷
インド		印度
インフォーマル		非正式的；非合法的
うえつける	植えつける	移植；栽培
ウエート		重量；重点，重要性
うけつける	受けつける	接受；采纳
うけみ	受け身	被动；守势
うたがう	疑う	怀疑，疑惑
うつりかわり	移り変わり	变化，变迁
うつる	写る	映现；照相
うらぎる	裏切る	辜负，出乎意料；背叛
うらづけ	裏付け	保证，证明；证据
うりきれる	売り切れる	卖完，脱销
えいえん	永遠	永远
えいこく	英国	英国
えきたい	液体	液体
えさ	餌	饵食；饲料
きょうつう	共通	共同，通用
きょうりょく	強力	强大
きょか	許可	允许，批准
きょくしょ	局所	局部
きょくせん	曲線	曲线
きらきら		闪烁，晃眼
キリストきょう	キリスト教	基督教
きりとる	切り取る	剪下，切下，割下
ぎろん	議論	议论，争论
きんぞく	金属	金属
きんだい	近代	近代，现代
きんにく	筋肉	肌肉
くうそう	空想	空想，幻想
くぎる	区切る	隔开，划分，分段
くず	屑	屑，碎片，废物
くすむ		(颜色等)不鲜艳，发暗
ぐたい	具体	具体
くだす	下す	下(决心)，降下
くむ	組む	联合，组成，把...交叉起来
くらし	暮らし	生活，生计
クリーム		奶油，雪花膏
くるう	狂う	失常，有毛病
くるしむ	苦しむ	痛苦，苦恼，苦于
くろ	黒	黑，黑色
けい	計	合计，总计
けい	系	系统，系列
けいき	景気	景气，繁荣
けいこうとう	蛍光灯	萤光灯
げかい	下界	低处，人间，下界
ケーキ		蛋糕，点心
けしょう	化粧	化妆，打扮
げざん	下山	下山
けつあつ	血圧	血压
けつえき	血液	血液
けっかん	欠陥	缺点，缺陷
けつろん	結論	结论
けん	軒	(房屋)所
けんかい	見解	见解
げんかい	限界	界限，限度
げんこう	原稿	原稿，草稿
げんこうようし	原稿用紙	稿纸
げんじつ	現実	现实
げんしょう	現象	现象
けんそん（する）	謙遜	谦逊，谦虚
けんとう	見当	推测，预计
げんば	現場	现场，车间，工地
こういう		这种，这样
こうか	效果	效果，成效
ごうか	豪華	豪华，奢华
こうきゅう	高級	高级，上等
こうきゅうしゃ	高級車	高级轿车
こうげき	攻撃	攻击，指责
こうさ	交差	交叉
こうさてん	交差点	交叉点，十字路口
こうして		这样
こうちゃ	紅茶	红茶
こうとう	高等	高等
ごうり	合理	合理
こくご	国語	国语，本国语言
こくせき	国籍	国籍
こげる	焦げる	糊，烤焦
こころえる	心得る	懂得，理解，领会
こころがまえ	心構え	精神准备，思想准备
こし	腰	腰，腰身
こたい	個体	个体
ごつい		粗糙，粗壮
こづつみ	小包	小包，邮包
ごと		每...
ことなる	異なる	不同，不一样
ことわる	断わる	拒绝，谢绝
こねる		和，揉和
このむ	好む	爱好，喜欢
コブシ		辛夷
ゴール		终点，球门
これまで		以前，以往，到此为止
ころ		以前，时期，...前后
コンクリート		混凝土
こんざつ（する）	混雑	混杂，混乱
こんせんだいち	根釧台地	根钏台地
こんらん（する）	混乱	混乱
さいこう	最高	最高
さいてい	最低	最低，最劣
サイレン		汽笛，警报器
サイロ		（储存饲料的）仓库，筒仓
さえる		（色彩）清晰，鲜明
さぎょう	作業	工作，操作
さけぶ	叫ぶ	叫，呼喊
サツキ		木本杜鹃
ささやか		细小，微小
さっさと		迅速，赶快
さっぱり		（后与否定语呼应）全然（不）
サーモスタット		恒温装置
さる	去る	离开
さんそ	酸素	氧气，氧
ジェットき	ジェット機	喷气式飞机
ジェット·パック		"小包封筒"（英语译音）
しかたない	仕方ない	没有办法
しかと		牢固，准确
しがみつく		紧紧抓住，抓住不放
じき	時期	日期，时候，季节
シグナル		信号，信号灯（机）
じこく	時刻	时刻，时候
じさぼけ	时差ぼけ	时差混乱
じしん	自身	自身，本身
しせい	姿勢	姿势，态度
しそう	思想	思想
しだい	次第	顺序，情况
したうち	舌打ち	咂嘴
したしみ	親しみ	亲密，亲切
しつ	室	室
しっく	疾駆	（车、马）疾驰，飞驰
じっこう	実行	实行
じっしゅうせい	実習生	实习生
しつど	湿度	湿度
じつに	実に	实在，的确
じつは	実は	实际上，说实在的
じどう	自動	自动
しばふ	芝生	草地，草坪
しはらう	支払う	支付
しぶき		飞溅的水花
しめる	湿る	湿，潮湿，发潮
しめる	占める	占，据有
しゃどう	車道	车（行）道
じゅう		整（个）...，全...
しゅうしょく	就職	就职，就业
じゅうたく	住宅	住宅
じゅうたん		地毯
しゅうとめ	姑	婆母，岳母
しゅうり	修理	修理，修缮
しゅだん	手段	手段，办法
しゅちよう	主張	主张
しゅっきん(する）	出勤	上班
しゅっぱん	出版	出版
じゅみょう	寿命	寿命，使用期限
しゅんかん	瞬間	瞬间
しょ	諸	诸...
じょうきょう	状況	情况，状况
しょうじ	障子	（日本式）拉门
じょうたい	状態	状态
しょうにん	承認	承认，认可
しょうひ	消费	消费，耗费
しょうぼう	消防	消防
しょうぼうふく	消防服	消防服
しょうめい	証明	证明
しょうわ	昭和	（日本年号）昭和
しょくよく	食欲	食欲
しょくりょう	食料	食品，食物，伙食费
しょせん		归根到底，反正
しょもつ	書物	书，书籍
しろ	白	白色，洁白
しろうと	素人	外行，业余爱好者
しん	真	真正，真实
しんかんせん	新幹線	新干线
しんけい	神経	神经，感觉
しんごう	信号	信号，暗号
じんこう	人工	人造，人工
しんこう	信仰	信仰
しんごうき	信号機	信号机
しんしつ	寝室	寝室
しんせん	新鮮	新鲜
しんだん	診断	诊断
しんに	真に	真正地
しんゆう	親友	亲密朋友
しんよう	信用	信用，信任
しんり	心裡	心理
しんるい	親類	亲属，亲戚
すいそ	水素	氢
すいみん	睡眠	睡眠
すう	数	数，数量
すえ	末	末，最后
すがりつく		缠住，抱住不放
すき		间隙，闲暇
スキー		滑雪
ずく		单靠，专凭
すごす	過ごす	过（日子）
すでに		已经，业已
すなわち		即，也就是说
スピート		速度，速率
すまい	住まい	居住，住址
スマート		潇洒，漂亮
せい		原因，缘故
せい	生	生
せい	正	正
せいいっぱい	精いっぱい	尽全力
せいご	生後	出生以后
せいはんたい	正反対	完全相反，正好相反
せいぶん	成分	成分
せおう	背負う	担负，背
せそう	世相	世态，社会情况
せっけい	設計	设计，规划
せっけいか	設計家	设计者，设计家
せっする	接する	遇到，接近
せっちゃく	接着	粘着
せってん	接点	接触点
セットポイント		设定点
せつやく	節約	节约，节省　
せまる	迫る	逼迫
せんご	戦後	战后，第二次世界大战后
せんこう	専攻	专业，专攻
ぜんしょう	全焼	烧完，烧毁
ぜんしん	前進	前进，提高
ぜんぜん	全然	一点也（不），全然（不）
センター		中心，中央
ぜんたい	全体	全体，总体
センチメートル		厘米
ぜんたい	全体	前提，前提条件
ぜんりょく	全力	全力，全部力量
ぞい	沿い	沿着...顺着...
そういう		那样的
ぞうか	増加	增加
そうげん	草原	草原
そうご	相互	相互，双方
そうぞう	想像	想象
そうばい	層倍	倍
そくりょく	速力	速度，速率
そしき	組織	组织，机构
そそぐ	注ぐ	流入
そっくり		全部，完全
そっちょく	率直	坦率，直率
そっと		悄悄地，轻轻地，偷偷地
そとがわ	外側	外面，外侧
そなえる	備える	准备，防备，备置
そのうち		而且，又
そんちょう	尊重	尊重，重视
そんなに		那样的，那么
だいいち	第一	第一，首要的
たいおん	体温	体温
たいおんけい	体温計	体温计（表）
だいがくいん	大学院	研究生院
たいさく	対策	对策，相应措施
だいじ	大事	重要，保证
タイプライター		打字机
タイヤ		轮胎，外胎
たいら	平ら	平，平坦
たいようけい	太陽系	太阳系
たいりく	大陸	大陆
たえる	堪える	经得起，耐
だが		但是，可是
だく	抱く	抱，怀有
たくわえる	蓄える	储蓄，贮藏
たしょう	多少	多少，稍微
たすう	多数	多数，许多
ただちに	直ちに	当即，直接
たった		仅，只
だって		即使是，就连
たとえる	例える	比喻，比作
えたいがしれぬ		莫明其妙的，离奇的
エチケット		礼仪，礼节
エンジン		发动机，引擎　
えんそ	塩素	氯，氯气
えんそく	遠足	郊游，徒步旅行
おいこす	追い越す	超过，越过
おいつく	追い付く	追上，赶上
おいつめる	追い詰める	穷追，追到绝境
おうえん	応援	援助，支援
おうべい	欧米	欧美
おおいに	大いに	很，非常
おおきさ	大きさ	大小，尺寸
おおぐち	大口	巨额；大批
おおて	大手	做大宗生意的人，大户头
おおよそ		大约，大致
おき	沖	（离岸较远的）海面，洋面
おさない	幼い	幼小的，幼稚的
おさまる	收まる	复原；纳入，装进
おしゃべり		闲谈；爱说话（的人）
オストラリア		澳大利亚
おそわる	教わる	受教，跟...学习
おてんばむすめ	おてんば娘	顽皮的女孩子
おのおの		各自，各
おのずと		自然而然
おびえきる		极其害怕
おまえ		你
おもいきる	思い切る	断念，死心
たはた	田畑	田地
たまったものではない		受不了，忍耐不了
たまる		积存，积压
だんし	男子	男子，男孩子
だんてい	断定	断定，判断
たんとう	担当	担当，担任
たんに	単に	仅仅，只，单
ちえ	知恵	智慧，智力
ちからづよい	力強い	有信心，强有力的
ちぢむ	縮む	缩，缩小
ちほう	地方	地方，地区
ちゃわん	茶碗	碗，茶杯
ちゅうし	中止	中止，停止
ちゅうと	中途	中途，半路
ちょうさ	調査	调查
ちょうしょく	朝食	早饭
ちょうせつ	調節	调节，调整
ちょうなん	長男	长子
チョコレート		巧克力色，巧克力
つい		方才，刚刚
ついきゅう	追求	追究，追求
ついて		（用について的形式）关于...就...而言
つうか	通過	通过，经过
つうがく	通学	走读
つうきん	通勤	上、下班，通勤
つうしん	通信	通信，通讯联络
つうねん	通念	普通的想法，一般的看法
つかむ		抓，抓住
つぎつぎに		接连不断，一个接一个地
ひなた		向阳处
ひにく	皮肉	挖苦，讽刺
ひはん	批判	批评，批判
ひびがいる	ひびが入る	裂纹
びみょう	微妙	微妙
びょうにん	病人	病人，患者
ひょうめん	表面	表面
びん	瓶	瓶
ピンク		粉红色
ぶ	分	（温度等的）分
ふあんてい	不安定	不安定
ふうけい	風景	风景，情景
ふかまる	深まる	深起来，深化
ふきゅう	普及	普及
ふくめる	含める	包含，包括
ふくらむ	膨らむ	膨胀，鼓起
ふすま		隔扇，拉门
ふせぐ	防ぐ	防止，防守
フットボール		足球
ふと		猛然，忽然
ブラウンかん	ブラウン管	显像管
ぶらさげる	ぶら下げる	悬挂，提
プラスチック		塑料，塑胶
ぶり		相隔，状态，方式
プリント		印刷，打印
プリントきばん	プリント基板	印刷电路版
あいする	愛する	爱，喜爱
おもいこむ	思い込む	坚信，确信
おもおもしい	重々しい	认认真真的；严肃的，郑重的
おもわく	思惑	想法，意图；期望
おもわず	思わず	不由得，情不自禁地
おやゆび	親指	大拇指
おり	折	时候，时机
オリンピック		奥林匹克运动会
おんせん	温泉	温泉
かい	貝	贝，贝类
がい	害	害处，危害
かいが	絵画	绘画，画
がいじん	外人	外国人，局外人
かいせい	改正	改正，修改
かいせん	回線	电路，线路
かいぜん	改善	改善，改进
かいちゅうでんとう	懐中電灯	手电筒
かいてき（だ）	快適	舒适，舒服
かいよう	海洋	海洋
がいらいご	外来語	外来语
かおり	香り	香气，芬芳
かかえる	抱える	负担，承担，抱
かがやかしい	輝かしい	辉煌的，光辉的
かかわらず		不管...，虽然...但是
ようし	容姿	姿容，姿态
ようする	要する	需要
ようするに	要するに	总之
ようそ	要素	要素，因素
ようと	用途	用途，用处
ようぶん	養分	养分
ようべん	用便	解手，大小便
よくじつ	翌日	翌日，次日
よけい	余計	格外，更加，更多
よごす	汚す	弄脏
よそ		别处，远处，远方
よそく	予測	预测，预料
よびかけ	呼びかけ	号召，呼吁
よびかける	呼び掛ける	号召，呼吁，召唤
よほう	予報	预防，提防
よめ	嫁	儿媳，新娘
よゆう	余裕	有余地，剩余，充裕
より		更（加），进一步
よろこび	喜び	喜悦，高兴
らしい		象...样子，象...似的
らんぼう	乱暴	粗暴，蛮横
りくじょう	陸上	陆（地）上
りくじょうきゅぎ	陸上競技	田径比赛
リズム		节奏，韵律
りょうきん	料金	费用
りんかく	輪郭	轮廓，概略
れつ	列	队列，列队
れっしゃ	列車	列车
レベル		水平，水准
レポート		报告，报导
れんごう	連合	联合
レンズ		透镜，镜头
つきもの	付き物	附属品，附带的东西
つく	突く	支，冒，冲
つける	着ける	穿
つたわる	伝わる	传导，流传
ツツジ		杜鹃花
つとめる	努める	努力，尽力
つながる		连接，连络
つなぐ		连接，系
つね	常	常事，平常
つねづね	常々	常常，经常
つねに	常に	时常，经常
つぶ	粒	粒，颗粒
つぶす		毁坏，弄坏
つめる	詰める	填，装
つもる	積もる	堆积，积累
つゆ	梅雨	梅雨，梅雨天
つりあう	釣り合う	平衡，平均
ていこう	抵抗	抵抗，阻力
ていさいや	体裁屋	说奉承话的人
ていど	程度	程度，适度
てきする	適する	适宜，适合
デザイナー		设计家，设计师
でたらめ		荒唐，胡扯
てま	手間	时间，功夫
てまえ	手前	自己的面前，这边
てる	照る	照，晒
てんこう	天候	气候，天气
でんせん	電線	电线
でんとう	伝統	传统
でんぷん		淀粉
どうか		设法，请
どうかしている		不正常，怪
どうし		同伴，伙伴
どうしても		无论如何也，一定
とうぜん	当然	当然，理所当然
とうてい		无论如何也（不），...，怎么也（不）...
とうとい	尊い	贵重的，珍贵的，高贵的
とうめい	透明	透明
とうよう	東洋	东洋，东方
どうよう	同様	同样，一样
トカゲ		蜥蜴
とかす	溶かす	溶化，熔化
とがる		尖，紧张
とくちょう	特徴	特征，特点
とける	溶ける	溶化，溶解，熔化
とこや	床屋	理发店，理发师
とざん	登山	登山
としとる	年取る	上年纪，上岁数
とっさ		一瞬间，突然
とばす	飛ばす	使...飞，使...奔驰
とびだす	飛び出す	飞起来，跑出去，起飞
ともかく		故且不论，不管怎样
とらえる	捕える	抓住，捕获
とりあげる	取り上げる	提出，采纳
とりいれる	取り入れる	采用，吸收
とりだす	取り出す	取出，拿出，抽出
とりまく	取り卷く	围，包围，捧场
どろ	泥	泥
とんでもない		不合情理的，毫无道理的
とんと		一点也（不）
どんなに		如何，怎样
な	名	名，名称，姓名
ないか	内科	内科
なおす	治す	治疗
なお		还有，再者
ながす	流す	使...流，传播，冲洗
なげかける	投げかける	扔过去，提出
ならす	鳴らす	鸣，出声
なんじ	汝	你，你们
なんど	何度	屡次，几次
なんとも	何とも	什么...也
なんびゃく	何百	数百
にくい		难，难以
にじゅう	二重	双层
にちじょう	日常	日常
にわか		突然，马上
ぬける	抜ける	脱落，脱离
ネオンサイン		霓红灯，氖灯
ねっする	熱する	加热
ねらい		目标，目的
ねんきん	年金	每年支给的定额养老金
ねんだい	年代	年代，时代
のけもの	のけ物	被排挤在外的人
のこり	残り	剩余，残余
はきょく	破局	悲惨的结局
はさむ	挟む	夹，夹住
バスケットボール		篮球
はだ	肌	肤，皮肤
はたらき	働き	作用，效力
はち		蜂，蜜蜂
ばっこん	拔根	拔根
はつばい	発売	发售，出售
はてしない	果てしない	没有边，无止境
はねる	跳ねる	溅，飞溅
はば	幅	幅度，宽度
ババぬき		（新婚小家庭中）没有母亲同住
はブラシ	歯ブラシ	牙刷
はやおき	早起き	早起，早起的人
パリ		巴黎
はるか		远，遥远
バレーボール		排球
はんせい	反省	反省
はんめい	判明	弄清楚
はんろん	反論	反对意见
ひ	非	非...不...
ひがい	被害	被害，受害
ひき、ぴき、びき	匹	匹、头、只
ひじょう	非情	无情
ひづけ	日付	年月日，日期
ひつじ	羊	羊
ふれる	触れる	接触，涉及
ブロック		块砖，预制件
ふんいき	雰囲気	气氛
ぶんかい	分解	分解
ぶんせき	分析	分析，研究，化险
ぶんたん	分担	分担
ぶんぼうぐ	文房具	文具
ぶんぼうぐてん	文房具店	文具店
ぶんめい	分明	文明
へいきん	平均	平均，均衡
べいこく	米国	美国
べっこ	別個	另一个，个别
ヘルメット		头盔，防护帽
ぽい		表示某种倾向很突出
ほうこう	方向	方向
ほうしん	方針	方针
ほうそく	法則	规律，定律
ぼうたかとび	棒高飛び	撑杆跳高
ほうる		放弃，弃而不顾
ほうれんそう		菠菜
ほこうしゃ	歩行者	步行者，行人
ぼしゅう	募集	招募，招集
ほす	干す	晒，把（水）弄干
ほっかいどう	北海道	北海道
ほね	骨	骨，骨头
ほぼ		大约，大体上
ホルモン		荷尔蒙，激素
ぼんやり		模模糊糊，不清楚
ほんらい	本来	本来，原来
ま	真	真正
マイコン		微型计算机
まがりとおる	まがり通る	强行走过，肆行无阻
マージャン		麻将
ます		方格
まぢか	間近	临近，靠近
まちがい	間違い	错误，不准确
まどぐち	窓口	窗口
まねく	招く	招致，惹起
まれ		稀少，稀奇
まんいち	万一	万一，倘若
み	身	身（体），自身
みかた	見方	看法，见解
みさだめる	見定める	认准，断定
みじめ	惨め	悲惨，惨痛
みずから	自ら	自已，自身
みずたまり	水たまり	水坑
みつめる	見詰める	凝视，注视
みより	身寄り	亲人，亲属
みるにたえない	見るに堪えない	不堪入目
みわける	見分ける	区分，识别
む	無	无...，没有
むほご	無保護	无保护
むしあつい	蒸し暑い	闷热的
むしろ		宁可，莫如，与其...不如
むっと		（空气）闷得慌
むりをしない	無理をしない	不勉强
めあて	目当て	目标，目的
れんぞく	連続	连续，顺序
ろうじん	老人	老（年）人
わだい	話題	话题，谈话材料
わたくず	棉くず	棉屑
わたる		关系到，涉及到
アイデア		主意，想法，理想
あいぼう	相棒	伙伴，同伴
あいまい		含糊，不明白
あう	遭う	遭遇，碰上
あからがお	赤ら顔	发红的脸，红脸膛
あきらめる	諦める	断念，死心
アクシデント		事故，灾祸
あこがれる	憧れる	憧憬，向往
あさひ	朝日	旭日，《朝日新闻》
あしおと	足音	脚步声
あしくび	足首	踝，脚脖子
あしもと	足元	脚底，脚下，眼前
あそびほうける	遊びほうける	游玩入迷，游玩成性
あたし		我（女性）
あたりまえ	当たり前	应该，理所当然
あっ		啊，哎哟
アナウンサー		播音员
あびる	浴びる	遭受；淋，浴
あらた	新た	新，重新
あり		蚂蚁
アルバム		影集，照相簿
かぶせる		蒙上，盖上
かみそり		剃刀，刮脸刀
かみのけ	髪の毛	头发
かよう		这样，如此
から	殻	皮，外壳；空壳
かり	仮	临时；暂时
がる		觉得...，显得...
かわいがる		喜爱，疼爱
かわいらしい		可爱的，小巧玲珑的
かん	観	...观(点)；外观
かんがえ	考え	想法，主意
かんかく	感覚	感觉
かんこう	観光	观光，游览
かんじょう	感情	感情
かんじん	肝心	重要，首要
かんせい	完成	完成
かんそう	乾燥	干燥，枯燥
かんづめ	缶詰	罐头
かんとう	関東	(日本)关东地区
かんどう（する）	感動	感动
かんぱ	寒波	寒潮，寒流
かんばん	看板	招牌，广告牌
かんり	管理	管理
きいろ	黄色	黄色
きがかり	気掛かり	担心，挂念
きかん	機関	机关，组织
ききて	聞き手	听众
ききながす	聞き流す	置若罔闻，充耳不闻
きぎょう	企業	企业
きく	利く	好使，灵便
きく	效く	有效，起作用
きぐ	器具	器具，工具
ぎこちない		动作笨拙，不灵活
めい	名	（表示人数）...名，...人
めいじ	明治	明治（日本年号）
めくる		翻开，掀开
めぐる	巡る	旋转，循环，巡游
めざす	目指す	把...作为目标
めった(に)		(不)多...,(不)常...
もったいない		可惜的，浪费的
もどす	戻す	退回，归回
もともと	元々	本来，根本
ものがたり	物語	传说，故事
もろい		脆的，易坏的
もんく	文句	不满，牢骚
もんくをいわれる	文句を言われる	被说闲话，被提意见
もんぶしょう	文部省	文部省（日本政府的教育部）
やくす	訳す	翻译　
やくひん	薬品	药品
やくわり	役割	分配（的）任务，分派（的）职务
やってくる		来，到来
やぶる	破る	弄破，打破
ヤマブキ		棣棠
ゆいいつ	唯一	唯一
ゆうこう	有效	有效
ゆうびん	郵便	邮件，邮政
ゆうびんぶつ	郵便物	邮件
ゆえ	故	缘故，理由，情况
ゆずる	譲る	让给，礼让
ゆだんもすきもならない	油断もすきもならない	不可麻痹大意
きざむ	刻む	刻，铭刻；切碎
きし	岸	岸，滨
ぎし	技師	工程师，技师
きしゃ	記者	记者
きたい	期待	期待，期望
きっかけ		契机，捐赠
きまえよく	気前よく	大方地，慷慨地
ぎもん	疑問	疑问，疑惑
きゅう	旧	旧，陈旧
きゅうきゅう		一心一意，念念不忘
きゅうきょ		急忙，匆忙
きゅうじつ	休日	假日，休息日
ぎゅうにゅう	牛乳	牛奶
きゅうり		黄瓜
きゅうりょう	給料	工资，薪水
きょうい	脅威	威胁，胁迫
きょうじゅ	教授	教授；教学，讲授
きょうどう	共同	共同
きょうふ	恐怖	恐怖，恐惧
きょうよう	教養	教养，修养
きょだい	巨大	巨大
キロメートル		公里，千米
きんちょう	緊張	紧张
く	句	句，句子；短语；俳句
く	区	区，区域
くい	悔い	后悔，懊悔
くう	食う	吃；消费，消耗
くさり	鎖	锁链，链条
くさる	腐る	腐朽，腐败
くずす	崩す	使崩溃；拆毁
くちびる	唇	嘴唇
くにぐに	国々	各国，各地
くみたてる	組み立てる	组装，装配
クーラー		冷气机，空调机
クラブ		俱乐部
グラフ		图表，图解；画报
クリスマス		圣诞节
グループ		小组，集团；伙伴
くんれん	訓練	训练
けいえい	経営	经营，管理
けっか	結果	结果，结局
げっきゅう	月給	月薪，工资
けっちゃく	決着	解决，结束；着落
けん	権	权(力)，权限
げんご	言語	语言，言语
げんざい	現在	现在，目前
ケンタッキーしゅう	ケンタッキー州	(美国)肯塔基州
けんとう	検討	研讨，探讨
こ	小	小，微小
ご	碁	围棋
こいねがう		渴望，希求
こうおん	高温	高温
ごうかく	合格	合格，及格
ごうけい	合計	总计，合计
こうし	講師	讲师
かく	各	各...，每...
かく		搔，挠
かぐ		嗅，闻
がく	学	学校，学问
がく	額	数额，数量
かくだい	拡大	扩大，放大
かくち	各地	各地
かくど	角度	角度，观点
かくまう		隐匿，窝藏
がくもん	学問	学问，学识；学习
かげえ	影絵	影画；影子戏
かざん	火山	火山
かすがい		纽带；锔子
かすみ		靄，霞
かせぐ	稼ぐ	赚钱，挣钱
かたほう	片方	一方，两者中的一个
かたみち	片道	单程；单方面
かたむく	倾く	倾斜；倾向于
かたる	語る	谈，说
かつ		同时，而且
かっか		兴奋，某种活动非常激烈的样子
かつぐ	担ぐ	扛，挑
がっしゅく	合宿	集训，集体住宿
かっぱつ	活溌	活泼，活跃
がつん		猛然，坚决地；当啷，锵一声（硬物相撞时所发出的声音)
かてい	過程	过程
カード		卡片
かなう		比得上，敌得过；适合
かなしむ	悲しむ	悲痛；悲伤
カバー		覆盖物，外罩；罩上，套上
かぶき	歌舞伎	歌舞伎
こうせい	構成	构成，结构
こうぞう	構造	构造，结构
こうたい	交替	轮流，替换
こうど	高度	高度
こうほ	候補	候选人，修补
こうりょ	考慮	考虑，思考
こおる	凍る	结冰，冻结
こがた	小形	小型
こくてつ	国鉄	国营铁路
こくみん	国民	国民
こくりつ	国立	国立
ごじゅう	五十	五十，五十岁
こじらせる		使病等恶化；使复杂化
コース		航线，路线；课程
ごぞんじ	ご存知	您知道，您认识
コーチ		教练，技术指导
こっか	国家	国家
こっかい	国会	国会，议会
ごてん	御殿	豪华的住宅，府第
ことわざ		谚语
こな	粉	粉，粉末
このみ	好み	爱好，嗜好；流行
ごめん		对不起，请原谅
こや	小屋	简陋的小屋，窝棚；临时性小屋
ごらん		观赏；...试试看
ゴルフ		高尔夫球
ころがる	転がる	滚，倒下；躺下
ころぶ	転ぶ	事态变化；跌倒
こん	紺	藏青，深蓝
こんなに		这样地，这么
さい	際	当...时，当...之际
ざいさん	財産	财产
さいはい		指挥；作战时主将的令旗
さからう	逆らう	违逆，不服从
さきごろ	先ごろ	前些天，不久以前
さきざき	先々	将来，很早以前
さく	昨	昨...
さけ		鲑鱼，大马哈鱼
ささえる	支える	支持，维持
たちあがる	立ち上がる	恢复；站起
たちまち		立即，不大工夫；忽然
たちむかう	立ち向かう	对抗；应付；前进
たっする	達する	达到，完成，到达
たて	縦	竖，纵；切断
だて	建て	楼房的层；房屋建筑样式
たとえ		纵然，即使
たにん	他人	他人，别人；外人
たのしみ	楽しみ	快乐，乐趣；安慰
たび	旅	旅行
たまたま	偶々	偶尔，偶然
たまねぎ		洋葱
ためす	試す	尝试，试验
たんい	単位	单位；学分
だんかい	段階	阶段，时期；等级
たんじゅん（だ）	単純	单纯；简单
ダンス		跳舞，舞蹈　
たんなる	単なる	仅，只
たんぱく		蛋白，蛋白质
ち	地	地，大地
ちいき	地域	地域，区域
ちか	地下	地下；秘密地方
ちじん	知人	熟人，相识
ちたい	地帯	地带，地域
ちちおや	父親	父亲
チーム		运动队；团体，组
チャンス		机会，时机
ちゃ	茶	茶；茶水
ちゅうい	中位	中等水平；当中
ちゅうかん	中間	中间，两者之间
しのびよる	忍び寄る	偷偷靠近，悄悄接近
しばしば		屡次，常常
じまん	自慢	自豪；自满，夸耀
しみじみ		仔细，认真；深切
しみん	市民	市民，公民
じむ	事務	事务，业务
しめくくる	締めくくる	概括，归纳；管束管理
しゃくん	社訓	公司的规则（训诫）
しゃぜ	社是	公司的基本方针
シャワー		沐浴
じゅう	銃	枪
しゅうきょう	宗教	宗教
じゅうじゅん	従順	顺从，温顺
しゅうせい	修正	修正；订正
しゅうだん	集団	集团，集体
しゅうちゅう	集中	集中
じゅうみん	住民	居民
じゅうらい	従来	以前，从来
しゅぎ	主義	主义，主张
じゅぎょうりょう	授業料	学费
しゅしょう	首相	首相，总理
じゅけん	受験	投考，应试
しゅっちょう	出張	出差
しゅっとう	出頭	出面，报到
しゅと	主都	首都
しゅふ	主婦	主妇；女主人
しゅよう	主要	主要
シュール(レアリズム)		超现实主义
じゅんかん	循環	循环，重复
しょうが		姜，生姜
しょうぎ	将棋	将棋，日本象棋
じょうげ	上下	上下（关系）
ささやく		耳语，小声说话
さじ		匙
さしずめ		归根到底，总之
さしみ	刺身	生鱼片
さす	差す	注入，倒进
さすが		不愧，毕竟
さつえい	撮影	摄影，照相
さっか	作家	作家
さっこん	昨今	最近，近来
さまたげる	妨げる	妨碍，阻挠
さら	皿	盘状物；碟子
さらし		漂白布
さらり		干脆，果断
サラリーマン		工薪阶层，职员
さわがしい	騒がしい	吵闹的，喧哗的
さんかっけい	三角形	三角形
ざんぎょう	残業	加班加点
さんち	産地	产地；出生地
し	氏	氏；（主要接男子姓名后表示尊称）先生
しきり	仕切り	间隔，隔开；间壁
しぐさ		动作，姿势
しげき	刺激	刺激，使...兴奋
しげん	資源	资源
しこく	四国	四国（日本地名）
しじ	指示	指示，指令
ししゅう	刺しゅう	刺绣
じしん	自信	自信，信心
しだいに	次第に	依次，逐渐地
じたく	自宅	自已的住宅，本宅
じつりょく	実力	实力；武力
してつ	私鉄	私营铁路
しな	品	物品，东西
しょうすう	少数	少数
じょうだん	冗談	笑话，玩笑
しょうにん	商人	商人
しょうぶ	勝負	胜负，输赢
じょうほう	情報	情报；信息，消息
しょるい	書類	文件
しりぞく	退く	退出，后退
しりつ	市立	私立，私营
しりょう	資料	资料
しる	汁	汁，液
しわ		皱纹，褶子
しん		芯；嫩芽
しんがく	進学	升学
しんこく	深刻	深刻，严肃
しんずる	信ずる	相信，确信，信仰
しんりん	森林	森林
すいじ	炊事	烹调，炊事
すいちょく	垂直	垂直
すいとりがみ	吸取紙	吸墨纸，吸水纸
スイマー		游泳运动员
すくなくとも	少なくとも	至少，最低
スケジュール		日程表，程序表
スケート		滑冰，溜冰；冰鞋
すこしも	少しも	一点也（不）...
すじ	筋	情节；筋；线条
すじみち	筋道	条理；顺序
すす		煤烟子；灰尘
スタイル		风格，文体；样式
スタート		出发点；开始
ちゅうしょう	抽象	抽象
ちょうこく	彫刻	雕刻
ちょうし	調子	身体状况；状态；调子
ちょうしょ	長所	长处，优点
ちょうじょう	頂上	山顶，顶峰；极点
ちょうせい	調整	调整，调节
ちょくご	直後	...之后不久，紧接着
ちらす	散らす	把...分散开；散布
すっきり		舒畅；流畅，通顺
すてき		极好，绝妙
スパイ		间谍
スーパーマーケット		超级市场，自选市场
スープ		（西餐）汤
すみ	炭	炼焦之物；炭，木炭
すんぽう	寸法	尺寸
せい	製	...制，...制造
せいかく（だ）	正確	正确，准确
せいかく	性格	特征，特性；性格
せいぞん	生存	生存
ぜいたく		奢侈，铺张浪费
せいのう	性能	性能，效能
せいへき	性癖	癖好，积习
せけん	世間	人世间，社会
せつ	説	意见，主张；学说
せっきょく	積極	积极，主动
ぜんいん	全員	全体人员
ぜんご	前後	前后；相继
せんじつ	先日	前几天，前些日子
ぜんぱん	全般	全面，全体
せんぷうき	扇風機	电扇；鼓风机
せんろ	線路	（火车等的）线路；轨道
そうぞうしい	騒々しい	喧哗的，吵闹的
そうとう	相当	[名.自サ]相当；适合　[副.形动]　颇，很　
そうり	総理	总理
ぞくする	属する	属于，归于
ソフト(ウエア)		软件，程序设备
そぼく	素樸	素朴，纯朴
そむける	背ける	（把脸、背等）转过去
そもそも		毕竟，原来；说起来
それなら		如果那样，要是那样的话
そろえる		使...一致；齐备
ぞんじる	存じる	认为；知道
た	他	其他，别人
だい	台	辆，台，架
たいいく	体育	体育
たいかい	大会	大会
だいこん	大根	萝卜
たいじゅう	体重	体重
たいしょう	対象	对象，客体
だいしょう	大小	大大小小，大小
だいじん	大臣	大臣
たいせい	体制	体制
だいとうりょう	大統領	总统
だいぶぶん	大部分	大部分，多半
たいへいよう	太平洋	太平洋
ダイヤル		拨号盘；刻度盘
たいりつ	対立	对立，对峙
たえず	絶えず	不断，经常
たかめる	高める	提高，抬高，加高
たく	宅	住宅，家
タクシ－		出租汽车，计程车
たたえる		洋溢；装满
たち		...们，...等
ついきゅう	追究	追究，觉究
つかまる	捕まる	抓住，揪住；被捕
つきあう		交往，交际；陪伴
つく	就く	就（座）；就（职）
つぐ	次ぐ	次于；接着
つくづく		仔细；深刻地；切实
つけくわえる	付け加える	补充，附加
つたう	伝う	顺，靠，沿
つちかう	培う	培养，培植
つっこむ	突っ込む	钻进；插入
つまる	詰まる	堵塞；充满
で		那么；因为...所以
であう	出会う	遇到，碰见
ていか	低下	低落，下降
ていしゅつ	提出	提出；提交
できあがる	出来上がる	做完，竣工
あじわう	味わう	玩味；品尝
あつかう	扱う	对待，接待；使用，操作
あっしゅく	圧縮	压缩，挤压
あばれる	暴れる	（胡）闹
あまど	雨户	木板制套窗，木板制套门
あまる	余る	余，剩；过分
あやしい	怪しい	奇怪的，可疑的
あん	案	方案，计划；想法，主意
あんがい	案外	意外，没想到
あんなに		那样地，那么
いきなり		突然，冷不防
いご	以後	以后，之后；今后
いちば	市場	市场
いったん	一旦	一旦，万一；既然
いっぽう	一方	（两个中的）一个；一方，一方面
いばる	威張る	摆架子
イメージ		（影）像，图像，形象
いわ	岩	岩（石）
うけとり	受け取り	收（领），理解方式
うすぐらい	薄暗い	微暗的
うずめる	埋める	（掩）埋；覆盖，填（补）
うちゅう	宇宙	宇宙
できごと	出来事	事件，事故
でこぼこ	凸凹	凹凸不平，高低不平；不均衡
デ-タ		数据
てつがく	哲学	哲学
てってい	徹底	彻底，贯彻到底；全面，普遍
デート		（男女）约会；日期
テニス		网球
てのひら	手の平	手掌
てんかい	展開	展开，开展
でんき	伝記	传记
でんし	電子	电子
てんしん	転身	改变职业，改变身分等；转身
でんせん	伝染	传染　
てんねん	天然	天然，自然
と	都	东京都；首都
といかけ	問い掛け	询问，提问
とうけい	統計	统计
とうじつ	当日	当天，当日
どうせ		终归，无论如何
とうぶん	当分	目前，最近
ときに	時に	偶尔，有时
とく	解く	解开；解释，解答
とこのま	床の間	壁龛
とだな	戸棚	柜，橱
とたん	途端	刚...的时候，正巧
どっぷり		完全（沉浸）；（把毛笔等）蘸満（墨汁）
とない	都内	东京都内；都城内
とびこむ	飛び込む	投入；跳进；突然闯进
ドラマ		戏剧；戏剧性事件
トランプ		扑克牌，纸牌
とりひき	取引	交易，做生意
とれる	取れる	消除，解除
とろび	とろ火	文火，微火
トン		吨
トンネル		隧道，山洞；风洞
ないじつ	内実	内情，实情
なかば	半ば	中叶，一半；中央，在...当中
なかみ	中身	内容；内装的东西
なかよし	仲良し	友好，相好，好友
ながれ	流れ	水流；潮流
なぐさめる	慰める	安慰，安抚
なぜなら(ば)		因为，原因是
なっとく	納得	信服，理解，领会
なやむ	悩む	苦恼，烦恼
ならば		那么；如果可能的话
なんと		多么；怎样
なんらか		某些，多少，稍微
にっちゅう	日中	白天；正午；日本与中国
ニュ-ヨ-ク		（美国）纽约
にんじゅう	忍従	忍受，隐忍服从
ねぐるしさ	寝苦しさ	难以入睡
ねじ		螺丝，螺栓
ねじる		拧，扭
ねつく	寝付く	睡着，入睡
ねっしん（だ）	熱心	热心，热情
ねんれい	年齢	年龄
のうりょく	能力	能力
のこぎり	鋸	锯，锯子
のせる	載せる	把...放上，摆上；登载
のぞく		露出，露出一点；窥视
のばす	伸ばす	发挥，施展；伸直
のびる	伸びる	伸长，长高；发展
のべる	述べる	叙述，说明
ノ-ベルしょう	ノ-ベル賞	诺贝尔奖
のんき		安闲，悠闲
のんびり		舒舒服服，悠然自得
ば	場	场所，地点
ばいしゅう	買収	收买；收购
はえる	生える	生长
はかどる		（工作等）顺利进展
はく	泊	宿；过夜
はしご		梯子
はずす	外す	取下，解开；避开
パーセント		百分率，百分之...
はだし		赤脚，光着脚
はたして	果して	果然，果真
はちじゅう	八十	八十；八十岁
はっき	発揮	发挥，施展
バックアップ		支持，做后盾
ばっさり		一刀斩断，坚决除去
はっそう	発想	构思；主意
ばったり		突然倒下貌；突然相遇貌
はっと		吃惊貌；突然想起貌
ぱっと		突然一下子；做出的突然动作
ハ-ド(ウエア)		硬件
ははおや	母親	母亲
はぶく	省く	精简，省略
はやる		流行，时兴；兴旺
バランス		平衡，均衡
はりがね	針金	铁丝，金属线
はりきる	張り切る	鼓足干劲；拉紧
はれる		肿，肿胀
はんえい	反映	反映；反射
はんだん	判断	判断；推测
はんとし	半年	半年
ばんのうあいかぎ	万能合鍵	万能钥匙
はんばい	販売	贩卖，出售
ひいずるくに	日出ずる国	日出之国（日本的美称）
ひき	引き	偏袒，引荐，提拔
ひきずる	引き摺る	拖、拉、曳
ひずみ		歪斜；变形
ひたる	浸る	沉浸，沉湎；浸泡
ひとけた	一けた	一位数
ひとさしゆび	人差し指	食指
ひとにぎり	一握り	一小部分；一把
ひとり	独り	独自，单独
ひとりひとり	一人一人	每人；一个人一个人地
ひねる	捻る	拧，扭
ひびく	響く	响；影响
ピ-マン		圆辣椒
ひみつ	秘密	秘密；暗中
ひも		细绳，带子
びょう	病	疾病；...病
ひょうか	評価	评价；定价
ひょうじょう	表情	表情
ひょっとしたら		或许，说不定
ひろめる	広める	传播，普及；扩大
ふうぞく	風俗	风俗
ふうふ	夫婦	夫妇，夫妻
ふえ		笛子，哨子
フォーマル		正式的；合法的
ふかい	不快	不愉快，不高兴
ぶき	武器	武器
ふこう	不幸	不幸，倒霉
ふごうり	不合理	不合理
ふじん	夫人	夫人
ふぞろい		不整齐，不一致
ふち	縁	边，框
ぶっきょう	仏教	佛教
ふてっかく	不適格	不合格；没资格
ふところ	懐	被环抱处；胸怀
ふなのり	船乗り	海员，船员
ふぼ	父母	父母
プライベート		私人的，个人的
ぶらさがる	ぶら下がる	吊着，悬挂
プラス		有利；相加，正号
ブランデー		白兰地酒
ふり	不利	不利
ふるう	振るう	显示，发挥；振作
ふるえる	震える	颤抖，发抖
ぶんだん	分断	分裂，断裂
ぶんや	分野	领域，范围，范畴
ペイ		工资，报酬
へいめん	平面	（水）平面
へこむ		凹下，洼下，陷下
へだたり	隔たり	差距，隔阂；差别
へだたる	隔たる	距离，间隔
べつべつ	別々	分别，各自
ベテラン		老手，老练
へる	経る	经过，通过；经历
へんこう	変更	变更，改变
ほ	歩	步
ほう	法	法（律）；（方）法
ぼうずあたま	坊主頭	光头，秃头
ほうせき	宝石	宝石
ほこり	誇り	自豪，荣誉
ほこる	誇る	夸耀，自豪　
ほしょう	保証	保证，担保
ポップアート		波普艺术（常以日常杂物为题材，把实物嵌入画与雕塑中的一种现代派艺术
ボーナス		奖金；红利
ほねぐみ	骨組み	骨架，骨骼
ほほえむ	微笑む	微笑
ほる	彫る	雕刻
ほんしゅう	本州	（日本）本州
ほんの	本の	仅仅，少许
まあ		啊，哎呀
まい	毎	每...
マイク		麦克风，话筒
まえむき	前向き	积极，进步；向前
まかせる	任せる	听任；委任
まかなう	賄う	维持，供应
まかふしぎ	まか不思議	非常离奇，不可思议
まくら		枕头；垫的东西
まさしく	正しく	的确，诚然
まざる	混ざる	混杂，夹杂
まちあわせる	待ち合わせる	等待会面
まちかまえる	待ち構える	等待，等候
まっか	真っ赤	通红，鲜红
まっくら	真っ暗	漆黑，乌黑
まぶしい	眩しい	耀眼的，眩目的
まま		一如原样，按照...的样子
み		表示情况、程度、样子
みあげる	見上げる	仰视
みかけ	見掛け	外表，外观
みごと	見事	出色，精彩；美丽
ミサイル		导弹；火箭
みちる	満ちる	满（潮）；充满
みっちゃく	密着	靠紧，粘着
みにくい	醜い	丑的，丑恶的，卑鄙的
やっきょく	薬局	药房
やど	宿	家；旅店
やりかた	やり方	做法，手段
やるき	やる気	干劲，干活的愿望
ゆいごんじょう	遺言状	遗嘱
ゆうきゅうきゅうか	有給休暇	工资照发的休假
ゆきづまる	行き詰まる	行不通，停滞
ゆくえ	行方	去向，下落；前途
ゆでる	茹でる	煮
ゆびさす	指さす	用手指
ユーモア		幽默，诙谐
ようい	容易	容易，简单
ようが	洋画	西洋画
ようき	容器	容器
ようご	用語	用词，措词；术语
ようさい	洋裁	西式裁剪；西式缝纫
ようは	要は	重要的是，归根到底
よく	欲	欲，欲望
よくも		竟能，竟敢
よす		停止，作罢；戒掉；辞掉（职务）
よびだす	呼び出す	唤出来，叫出来
よぶん	余分	过多地，多余，格外
よみうり	読売	（江户时代在街头）边读边卖的瓦版报纸；《读卖新闻》的简称
リアリズム		写实主义；现实主义
りつ	率	率，比率
れいぎ	礼儀	礼仪，礼节
れいぼう	冷房	冷气设备；放冷气
レモン		柠檬
ろうそく	蝋燭	蜡烛
ろうどうしゃ	労働者	工人，劳动者
ろうにん	浪人	失学学生（未考进大学而想继续参加高考的人）；流浪者
ロボット		机器人；自动装置
ろん	論	看法，观点，讨论
わが		我的，我们的
わく		产生，发生；涌出
わびる		道歉
わり	割	十分之一；比率
わりきる	割り切る	武断地决定，简单地下结论
わりに	割に	比较，格外，出乎意料
きふ	寄附	捐助，捐赠
こころならずも	心ならずも	出于无奈，不得不
せんとう	先頭	前头，最前头
ひょうげん	表現	表现；表达
あいかわらず	相変わらず	仍旧，依然如故
あかり	明かり	灯，光
うめる	埋める	埋；填
うらがえす	裏返す	反过来，翻过来
うらむ	恨む	怨恨，埋怨
うわさ	噂	传说，议论
えいきゅう	永久	永久
えいぶん	英文	英文
えいわ	英和	英日，英和
えん	縁	缘分；血缘（关系）
えんぎ	演技	演技；表演
えんげき	演劇	戏剧
えんぜつ	演説	演说，讲演
えんそう	演奏	演奏
おうせつ	応接	接待
おうだん	横断	横渡，横穿
おうよう	応用	应用，运用
おおざっぱ		粗略
おか	丘	丘陵，小山
おだやか（だ）	穏やか	平稳，平静；温和，和气
オートメーション		自动化
おとる	劣る	劣，次；不如
か	蚊	蚊
かいいん	会員	会员
かいふく	回復	恢复，康复
かいほう	解放	解放
かいほう	開放	开放
かう	飼う	饲养
かきとめ	書留	挂号（信）
かくちょう	拡張	扩张，扩充
かくにん	確認	确认，证实
かける	欠ける	缺少，不足
かざり	飾り	装饰（品）
かしこい	賢い	聪明的，伶俐的
かしゅ	歌手	歌手
がっかい	学会	学会
かっこう	格好	名:外形，形状；装束。形动:恰好，适当
かつじ	活字	铅字
かなづかい	仮名遣い	假名用法，假名拼写法
かならずしも	必ずしも	（与否定语呼应）（不）一定...,未必...
かね	鐘	钟
かみなり	雷	雷
からかう		逗弄，戏弄，嘲弄
かわせ	為替	汇票；外汇
かん	缶	罐，筒
かんきゃく	観客	观众
かんさい	関西	（日本）关西地区
かんせつ	間接	间接
ぎいん	議員	议员
きかん	期間	期间
きごう	記号	标记，符号，记号
きじ	記事	记事，消息，报道
きせる	着せる	使...穿上，给...着上
きにゅう	記入	填写
きばん	基盤	基础，底座
キャンパス		（大学）校园
きゅう	球	球
きよう	器用	巧，灵巧；手巧
きょうきゅう	供给	供给，供应
きょうしゅく	恐縮	恐惶，羞愧
きょく	曲	乐曲，曲子
きらう	嫌う	讨厌，厌恶
きれる	切れる	期满；中断
きんがく	金額	金额
ぐうぜん	偶然	偶然
くしゃみ		喷嚏
くしん	苦心	苦心，费心
くずれる	崩れる	破碎；崩溃，倒塌
くだ	管	管
くつう	苦痛	痛苦
くみあい	組合	公会，工会；合作社
みはる	見張る	看守，监督
みぶん	身分	身分；地位
みみもと	耳元	耳边，耳旁
みんかん	民間	民间；私营
むき	向き	方向，倾向
むす	蒸す	蒸；闷热
むち		鞭子
むでんき	無電器	无线电收发报机
むなしい	虚しい	徒然的，空虚的
むりやり	無理矢理	硬是，强迫
めいかく	明確	明确
めいさく	名作	名作，佳作
めいっぱい	目いっぱい	竭尽全力
めいめい	銘々	各个，各自
めざめ	目覚め	睡醒；觉悟
めでたい		可喜可贺的；幸运的
めもり	目盛り	刻度，分度
もうい	猛威	凶猛的来势
もうける	設ける	制定，设立
もぎとる	もぎ取る	夺走；拧掉
もぐる	潜る	潜入（水中等），钻进
もしかするか		或许，万一
もちぬし	持ち主	所有者，物主
ものごと	物事	事物，事情
もやす	燃やす	激起；燃烧
もよおし	催し	活动，集会；举办
もる	盛る	盛，盛满
モンスーン		季风
くわわる	加わる	增加，添加；加入，参加
ぐんたい	軍隊	军队
けいぞく	継続	继续
げいのう	芸能	（电影、戏剧、音乐、美术等群众性）娱乐活动（的总称）
けいようし	形容詞	形容词
けいようどうし	形容動詞	形容动词
げか	外科	外科
げしゃ	下車	下车
けち		吝啬，小气
けっさく	傑作	杰作
けはい	気配	迹象，苗头，情形
ゲーム		游戏；比赛
けわしい	険しい	险峻的
げんど	限度	限度
げんり	原理	原理
こ	粉	粉（末）
こい	恋	恋爱，爱情
こいびと	恋人	恋人，情人
こうか	高価	高价
こうきょう	公共	公共，公众
こうけい	光景	光景，情景
こうせい	公正	公正
こうてい	肯定	肯定，承认
こうむる	被る	蒙受，招致
こうもく	項目	项目
ごかい	誤解	误解，误会
こきょう	故郷	故乡
こぐ	漕ぐ	划（船）；荡（秋千）
こする	擦る	擦，搓，蹭
こっそり		悄悄地
こと	琴	古琴，筝
コピー		（名）副本，抄本。（名.他サ）复制，复印
こぼれる		露出；溢出
コミュニケーション		交流，通信
こゆび	小指	小手指
ごらく	娯楽	娱乐
こる	凝る	热中，入迷
ころす	殺す	杀，杀死；忍住，抑制
こんご	今後	今后，以后
コンピューター		电子计算机
こんやく	婚約	订婚
さいちゅう	最中	正在
さいばん	裁判	审判
さきほど	先程	刚才
さぐる	探る	探求，探访；寻，摸索
ざせき	座席	座席
さつ	札	纸币，钞票
さばく	砂漠	沙漠
サービス		服务，招待；奉送
さびる	錆びる	生锈
ざぶとん	座布団	座垫
さます	覚ます	弄醒
さめる	冷める	冷却，变冷
サラダ		沙拉
し	詩	诗
しあがる	仕上がる	做完，完成
じえい	自衛	自卫
じかに	直に	直接地
しじゅう	始終	（名）始终，自始至终。（副）经常，不断
しじん	詩人	诗人
しずまる	静まる	寂静，平静；减弱
じたい	事態	事态，局势
しつこい		执拗的，纠缠不休的；浓的
しっと	嫉妬	嫉妒
じっと		目不转睛地，聚精会神地
しっぴつ	執筆	执笔
じみ	地味	朴实，（朴）素
しめい	氏名	姓名
じめん	地面	地面
しゃがむ		蹲
しゃこ	車庫	车库
じゅうだい	重大	重大，重要
しゅご	主語	主语
しゅっしん	出身	籍贯，出身地；出身
しゅやく	主役	主角，主要人物
じゅんさ	巡查	警察
じゅんすい	純粋	纯粹，纯真
じゅんちょう	順調	顺利
じゅんばん	順番	顺序
しょうがい	障害	障碍，妨碍
じょうきゃく	乗客	乘客
じょうきょう	上京	进京，去东京
しょうご	正午	正午
じょうしゃ	乗車	乘车，上车
じょうじゅん	上旬	上旬
しょうばい	商売	商业，买卖
じょうはつ	蒸発	蒸发，汽化
しょうめん	正面	正面，对面
しょうりゃく	省略	省略
しょくば	職場	车间，工作单位
しょくひん	食品	食品
しょめい	署名	署名，签名
しょり	処理	处理
しり	尻	屁股，臀部
じんぶつ	人物	人物
す	巣	巢穴，窝
すいさん	水産	水产
すいせん	推薦	推荐
そうい	相違	差异，不同
そうおん	騒音	噪声
そうしき	葬式	葬礼
ぞうだい	増大	增大
そうち	装置	装置，装备
そくてい	測定	测量，测定
そくど	速度	速度
そのうち		过几天，不久
そんがい	損害	损失，损害，损耗，破损
だい	題	题目，标题
だいきん	代金	货款
たいけい	体系	体系，系统
たいほ	逮捕	逮捕
たすかる	助かる	得救；得到帮助
ただし	但し	但（是），可是
たたむ	畳む	叠，收拢　
だとう	妥当	妥当
たに	谷	山谷，山洞
つぶれる	潰れる	倒闭，坏
つみ	罪	罪
つり	釣り	垂钓；吊绳，吊钩
ていあん	提案	提案，建议
ていき	定期	定期
ていきけん	定期券	定期票，月票
ていし	停止	停止，停顿
ていしゃ	停車	刹车，停车
ていでん	停電	停电
でいり	出入り	出入；常来常往
てきせつ	適切	适当，恰当
てちょう	手帳	笔记本
てっぽう	鉄砲	步枪；枪炮
テーマ		课题，题目
てんいん	店員	售货员，店员
でんち	電池	电池
テント		帐篷
でんりゅう	電流	电流
でんりょく	電力	电力
とう	塔	塔
ずいひつ	随筆	随笔，漫笔
スカーフ		围巾
せいき	世紀	世纪；年代
ぜいきん	税金	税金，税款
せいぞう	製造	制作，制造
せいりつ	成立	成立
せきにん	責任	责任
せんぞ	先祖	祖先，先人
せんでん	宣伝	宣传，宣讲
ぞう	象	大象
たのみ	頼み	请求，依赖
たば	束	把，捆，束
ためらう		踌躇，犹豫　
たんき	短期	短期
だんち	団地	（住宅等）小区
チーズ		奶酪
ちゅうもく	注目	注目，注视
ちょっかく	直角	直角
ついで		顺便
つうよう	通用	通用，有效
つきあたる	突き当たる	碰上，撞上；挡住，走到尽头
とういつ	統一	统一
とうげ	峠	山口，山路顶点
どうさ	動作	动作
とうじょう	登場	出现；登场，登台
どうとく	道徳	道德
とうひょう	投票	投票
どうわ	童話	童话
とくしゅ	特殊	特殊，特别
とくしょく	特色	特色
どくとく	独特	独特，独有
どくりつ	独立	独立
ととのう	整う	完整，（文章结构）严谨
トラック		卡车，载重汽车
なか	仲	关系，交情
なぞ	謎	謎（语）
なでる	撫でる	抚摸
なま	生	未加工的；生的，鲜的
なまける	怠ける	懒，懒惰
なみき	並木	行道树
なんきょく	南極	南极；南极大陆
にあう	似合う	合适，相称
にがて（だ）	苦手	不擅长；不好对付
にくむ	憎む	憎恶，憎恨
にぶい	鈍い	沉闷的；钝的
にょうぼう	女房	妻，老婆
ねったい	熱帯	热带
ねっちゅう	熱中	热中，着迷
ねんげつ	年月	年月，光阴
のぞみ	望み	愿望；指望
のろい	鈍い	缓慢，迟缓
バイオリン		小提琴
ひてい	否定	否定
ビデオ		录像
ひとまず		暂且，姑且
ひびき	響き	响声，音响；反响，回音
ひひょう	批評	评价，评论
ひふ	皮膚	皮肤
ひよう	費用	费用
ビール		啤酒
びんせん	便箋	便条，字条，信纸
ふあん（だ）	不安	不安，不放心
ふくし	副詞	副词
ふける	更ける	（夜）深
ぶっか	物価	物价
ぶつかる		撞，碰；冲突
ふで	筆	毛笔
ふとう	不当	不（正）当
ふまん	不満	不满意
フライパン		平底锅
ブラウス		罩衫
ふりょう	不良	小流氓；不好
プログラム		节目（单）；进度（表）
ぶん	文	文章；句子
へいこう	平行	平行
ベンチ		长椅
ボーイ		男服务员；小男孩
ほうげん	方言	方言
ほうもん	訪問	访问
ぼうや	坊や	对男孩子的爱称
ほお	頬	颊
ほがらか	朗らか	舒畅，快活；晴朗
ほぞん（する）	保存	保存
ほどう	歩道	人行道
ぼん	盆	盘；盂兰盆会
ほんもの	本物	真货，真东西
マイナス		消极，不好；减（号），负（号）
マーケット		市场
まさか		（后与否定推量语呼应）决（不会）...，难道...
まとまる		集中；解决，结束
まんてん	満点	满分
みおろす	見下ろす	俯视
みのる	実る	结果实
みやこ	都	首都，都会
みょう	妙	奇妙；巧妙
むかい	向かい	对面
むげん	無限	无限，无止境
むこう	無効	无效，失效
むし	無視	无视
むすう	無数	无数　
めいしん	迷信	迷信
めうえ	目上	长辈，尊长
メモ		笔记，记录；备忘录
めんきょ	免許	执照，许可（证）
もくひょう	目標	目标
もち	餅	粘糕
もちあげる	持ち上げる	拿起，抬起
もとづく	基づく	根据，起因于
ものさし	物差し	尺度，标准；尺
ものすごい	物凄い	可怕的；惊人的，猛烈的
やくしょ	役所	官厅
やっかい	厄介	麻烦，难办；照顾
やっつける		狠整一顿；干完
ゆうしょう	優勝	优胜
ゆうひ	夕日	夕阳
ゆうり	有利	有利
ゆか	床	地板
ゆき	行き	（名）去，行（后缀）开往
ゆそう	輸送	运输
よあけ	夜明け	佛晓
よう	酔う	醉；头晕
ようき	陽気	爽朗
はいたつ	配達	投递（员），发送（人员）
はく	履く	穿（鞋）
ばくはつ	爆発	爆炸；爆发
はさまる	挟まる	夹，被...夹住
はずれる	外れる	脱落，掉下；不合（道理），落空
はだか	裸	裸体；裸露
はっしゃ	発車	发车，开车
はつでん	発電	发电
はなはだしい	甚だしい	非常的
はなやか	華やか	华丽，美丽；盛大，显赫
ばね		弹簧，发条
ばんち	番地	门牌号；住处
はんにん	犯人	犯人
ピアノ		钢琴
びじん	美人	美人
ようじん	用心	注意，警惕
ようち	幼稚	幼稚
ようちえん	幼稚園	幼儿园
ようてん	要点	要点
ようりょう	要領	要领；决窍
よき	予期	预期
よつかど	四つ角	十字路口
ヨット		体育（比赛）帆船
よなか	夜中	半夜
リットル		升，公升
りょうがわ	両側	两侧
れいがい	例外	例外
れいせい	冷静	冷静
ローマじ	ローマ字	罗马字
ろんぶん	論文	论文
わざと		故意
ハンドル		方向盘；手柄
アイロン		熨斗
アクセサリー		首饰；附件
あくま	悪魔	恶魔；凶恶的人
あと	跡	印迹，痕迹；迹象
あらためる	改める	改变，改正；改善
いきいき	生き生き	生动活泼；生气勃勃
いくぶん	幾分	多少；几分
おくりがな	送り仮名	送假名
おせん	汚染	污染
おどろかす	驚かす	使...吃惊
おび	帯	带，腰带
おぼれる	溺れる	淹（没），淹死；沉溺于
おまわりさん	お巡りさん	巡警，警察
おろす	卸す	批发
おんけい	恩恵	恩惠，好处；恩赐
おんたい	温帯	温带
いちじょ	一助	一点帮助
いはん	違反	犯规；违反
いらい	依頼	（委）托，（依）靠
うく	浮く	浮余，有剩余；漂，浮
うさぎ	兎	兔
うどん		面条
うまれ	生まれ	出生（地）；出身
うらみ	恨み	仇恨，怨（恨）
ウール		全毛，毛线
うれる	売れる	畅销，好卖
うろうろ		转来转去
うんと		很，非常
えいぎょう	営業	营业，经营
えがお	笑顔	笑脸
エプロン		围裙
えんかい	宴会	宴会
えんき	延期	延期
えんしゅう	演習	演习
えんじょ	援助	援助，帮助
えんとつ	煙突	烟囱，烟筒
オイル		石油；油（类）
おうたい	応対	应酬，接待
かいけい	会計	会计
かいさん	解散	解散，取消
かいし	開始	开始
がいしゅつ	外出	外出，出门
かかく	価格	价格
かくじ	各自	各自，每个人
かくべつ	格别	格外，特别
かじ	家事	家务，家事
かじょう	過剰	过剩，过量
かじる		咬，啃
かたな	刀	刀
がっきゅう	学級	年级，班
かつやく	活躍	活跃，活动
かもつ	貨物	货物
がら	柄	资格；人品；体格
かんしょう	鑑賞	欣赏，鉴赏
かんそく	観測	观察，观测
かんちょう	官庁	政府机关
かんとく	監督	监督；监督者
かんぱい	乾杯	干杯
きげん	期限	期限
きじ	生地	素质；布料
きすう	奇数	奇数，单数
きたい	気体	气体
きつい		刚强的；厉害的
きみょう	奇妙	奇妙，出奇
きゃくま	客間	客厅
きゅう	級	等级，班级
きゅうぎょう	休業	停业，歇业
きゅうげき	急激	急剧，激烈
きよい	清い	清的，清澈的
きょうかい	境界	界，边界
ぎょうれつ	行列	行列；队伍
きらく	気楽	舒适；轻松，随便
きんぎょ	金魚	金鱼
ぐうすう	偶数	偶数
くうちゅう	空中	空中，天空
くぎ	釘	钉子
くすりゆび	薬指	无名指
くたびれる		疲劳，疲乏
こうしき	公式	公式；正式
こうすい	香水	香水
こうせき	功績	功绩
こうせん	光線	光线
こうはい	後輩	晚辈，后辈
こうぶつ	鉱物	矿物
こごえる	凍える	冻僵
こしかけ	腰掛け	椅子，凳子
こしかける	腰掛ける	坐(下)
ごじゅうおん	五十音	五十音图
こてん	古典	古典
ころがす	転がす	滚动，转动；弄倒
こんかい	今回	这一回，这回
コンクール		竞赛会，会演
こんごう	混合	混合
こんだて	献立	菜单，菜谱
さい	祭	...祭,...节
さいそく	催促	催促
さいなん	災難	灾难
さいほう	裁縫	裁缝，缝纫
ざいもく	材木	木材，木料
サイン		签名
さかい	境	界线，分界
さくもつ	作物	农作物，庄稼
ざつおん	雑音	杂音
さべつ	差別	差别
さんすう	算数	算术，初级数学
しおからい	塩辛い	咸的
しかい	司会	司仪，主持会议
しきゅう	至急	火急，加急
じけん	事件	事件，案件
じしゅう	自習	自习
ししゅつ	支出	支出
しじょう	市場	市场，销路
しそん	子孫	子孙，后裔
シーツ		床单
しつぎょう	失業	失业
じっせき	実績	实绩
しつぼう	失望	失望
じつよう	実用	实用
してい	指定	指定
してん	支店	分店，分行
しぼう	死亡	死亡
しまい	姉妹	姐妹，姊妹
しゃっきん	借金	借钱，借款
しゅうかい	集会	集会
じゅうきょ	住居	住所，住宅
しゅうごう	集合	集合
じゅうし	重視	重视
しゅうてん	終点	终点，终点站
しゅうりょう	終了	终了，完成
しゅくじつ	祝日	节日
じゅつご	述語	谓语
しゅつじょう	出場	出场，上场
じょうきゅう	上級	高年级，上一级
しょうしゃ	商社	商行，商社
しょうてん	焦点	焦点
じょうとう	上等	上等，高级
しょうとつ	衝突	冲突，冲撞
じょしゅ	助手	助手，助教
しょっき	食器	食器，餐具
しらが	白髪	白发
しんさつ	診察	诊察，诊断
じんしゅ	人種	种族，阶层
しんだい	寝台	床；卧铺(车)
しんにゅう	侵入	侵入
しんらい	信頼	信赖，可靠
す	酢	醋
すいじゅん	水準	水平，水准
スイッチ		开关，电门
ずうずうしい		脸皮厚的，不在乎的
すきま	隙間	缝隙，间隙
スーツ		(上下身)成套西服
すませる	済ませる	做完；将就，凑合
すみ	墨	墨，墨汁
ずらす		错开，挪一挪
ずれる		移动；偏离
せい	姓	姓
ぜい	税	税
せいきゅう	請求	请求，要求，索款
せいけつ(だ）	清潔	清洁
せいげん	制限	限制，控制
せいしき	正式	正式，正规
せいとう	政党	政党
せいねんがっぴ	生年月日	出生年月日
せいべつ	性别	性别
せいほうけい	正方形	正方形
せいれき	西暦	西历，公元
セット		调整，固定，成套
セメント		水泥
せんす	扇子	扇子，折扇
そうこ	倉庫	仓库
そうりだいじん	総理大臣	总理大臣
そしつ	素質	素质，天资
そで	袖	袖子
そまつ	粗末	粗糙，简陋，简慢
そる	剃る	剃，刮
そろばん		算盘
くもり	曇り	阴天，多云
クリーニング		洗衣，洗涤
くれ	暮れ	年末，傍晚，季末
けいご	敬語	敬语
けいと	毛糸	毛线
けいとう	系統	系统；体系
げきじょう	劇場	剧场
げじゅん	下旬	下旬
げつまつ	月末	月末，月底
げひん	下品	下流，卑鄙
けむい	煙い	呛人的
けん	券	券；票据
げんきん	現金	现金
ご	語	语(言)，(单)词
こうくう	航空	航行
こうげい	工芸	工艺
こうこう	孝行	孝顺
こうさい	交際	交际，交往
たいくつ	退屈	无聊，郁闷，寂寞
たいこ	太鼓	鼓
たいざい	滞在	旅居，逗留
たいし	大使	大使
たいしょう	対照	对照，对比
だいり	代理	代理(店)
たがやす	耕す	耕(作)
たく	炊く	煮，烧
たっぷり		充分，足够
たのもしい	頼もしい	前途有为的，靠得住
ダム		水坎；水库
たんしょ	短所	短处，缺点
たんじょう	誕生	诞生，出生
たんす		衣柜，五斗橱
だんたい	団体	团体；集体
ちい	地位	地位，职位
ちぎる		掰碎；拧下来
ちぢめる	縮める	缩小，缩回，缩减
ちゅうじゅん	中旬	中旬
ちゅうせい	中世	中世纪
ちょうき	長期	长期
ちょうじょ	長女	长女
ちょうだい		领受，请给(我)...
ちょうほうけい	長方形	长方形
ちょきん	貯金	存款，储蓄
ちょっけい	直径	直径
つい	対	对；...双
ついか	追加	追加
つうち	通知	通知,告知
つうやく	通訳	翻译，译员
つきひ	月日	时光，岁月，太阳和月亮
つばさ	翼	机翼，翅膀
つまずく		受挫；趔趄，踉跄
つよき	強気	有骨气，刚强
ていれ	手入れ	修理，维修保养
てっきょう	鉄橋	铁桥
てっこう	鉄鋼	钢铁
てつづき	手続き	手续，程序
デモ		游行示威
でんきゅう	電球	电灯炮
てんけい	典型	典型
てんのう	天皇	天皇
でんぱ	電波	电波
テンポ		速度；拍子
とう	党	政党；同伙
どう	銅	铜
とうだい	灯台	灯塔，航标灯
とうばん	当番	值班(人)
どうりょう	同僚	同事；同僚
どく	毒	毒，毒物
どくしん	独身	独身
ところどころ	所々	处处，有些地方
トップ		第一，尖端
とも	友	友人，朋友
とりけす	取り消す	取消，作废
ナイロン		尼龙
ななめ	斜め	倾斜
なまいき	生意気	夸大；骄傲(自大)，狂妄
なわ	縄	绳(索)
なんべい	南米	南美
にくい	憎い	可憎的，讨厌的
にくらしい	憎らしい	可憎的，讨厌的
にごる	濁る	浑浊，变浊
にじ	虹	(彩)虹
にっこう	日光	日光，阳光
にっこり		微笑貌
にゅうしゃ	入社	进入公司
にる	煮る	煮炖
ねぼう	寝坊	睡早觉
ねんど	年度	年度
のうそん	農村	农村
のぞく	除く	除外，除去
のぼり	上り	上行(列车)，登；上升
のる	載る	登载，刊载
はあ		是，嗬，啊
はいいろ	灰色	灰色
ばいばい	売買	买卖
パイプ		管，烟斗
はか	墓	坟
はた	旗	旗(帜)
はっこう	発行	发行，发放
はで	派手	华丽，花哨
はんい	範囲	范围
はんけい	半径	半径
はんざい	犯罪	犯罪
パンツ		短裤
はんとう	半島	半岛
ひきょう	卑怯	怯懦，卑鄙
ピクニック		郊游，野游
ひこう	飛行	飞行
ひたい	額	额
ひっし	必死	殊死，拼命
ぴったり		正好，恰好；突然停止貌
ひとごみ	人込み	人群拥挤，人山人海(的地方)
ひょうし	表紙	封皮，封面
びょうどう	平等	平等
ピン		栓，销；别针
ふざける		开玩笑；戏弄
ふし	節	节；关节，骨节
ふじゆう	不自由	不自由，不如意
ふぞく	付属	附属
ふだ	札	牌子，条子
ぶだい	舞台	舞台
ふつう	不通	不通，不通信；没来往
ぶつける		打(中)；撞上
ぶひん	部品	零件
ふへい	不平	不平，不满
プラン		计划，方案
ふりむく	振り向く	回顾；回头
ふろしき	風呂敷	包袱皮
ぶん	分	部分，份儿；程度
ぶんすう	分数	分数
ぶんぷ	分布	分布，散布
ぶんるい	分類	分类
へい	塀	围墙
へいたい	兵隊	士兵，军队
へいや	平野	平原
べつ	別	按...分类
ベルト		皮带；安全带
ペンキ		油漆，涂料
べんじょ	便所	厕所
ぼうけん	冒険	冒险
ぼうし	防止	防止
ほうたい	包带	绷带
ほうぼう	方々	各方，到处
ほどく		解开，拆开
ほのお	炎	火焰，火苗
まいご	迷子	迷路的孩子
まう	舞う	飞舞，飘荡，跳舞
まく	幕	幕；(戏剧)一幕
まさつ	摩擦	摩擦
マスク		口罩；面具
まっくろ	真っ黒	乌黑
まっしろい	真っ白い	雪白的
まねる	真似る	模仿，仿效
まわりみち	回り道	绕道，绕远
ミシン		缝纫机
みずぎ	水着	游泳衣
みっともない		难看的，不象样的
みほん	見本	样品，典型
ミルク		牛奶
みんよう	民謡	民谣，民歌
めいし	名詞	名词
めいしょ	名所	名胜(古迹)
めいぶつ	名物	著名特产，著名人物
めんせつ	面接	面试，接见
もうしこむ	申し込む	预约，报名
もうふ	毛布	毛毯
もしも		假如...，如果
もうしわけない	申し訳ない	实在抱歉，非常对不起
モーター		电动机，发动机
モダン		时髦，现代
モデル		模特儿，模型
もんどう	問答	问答，议论
やけど	火傷	烧伤，烫伤
やとう	雇う	雇佣
ゆうこう	友好	友好
ゆうしゅう	優秀	优秀
ゆうりょう	有料	收费
ゆかた	浴衣	浴衣
ゆげ	湯気	热气，蒸气
よう	様	...样子，...方式
ようもう	羊毛	羊毛
よこぎる	横切る	横穿
よさん	予算	预算
ラケット		球拍
りこう	利口	伶俐，机灵
りょうがえ（する）	両替	兑换，换钱
りんじ	臨時	临时，暂时
れんが	煉瓦	砖
ロビー		大厅，休息室
わ	輪	圈，环；(车)轮
わかわかしい	若々しい	年轻轻的
わふく	和服	和服
わりざん	割り算	除法
わりびき	割引き	减价，打折扣
あおぐ		扇(风)
アーク		(圆)弧，弓形；弧光；电弧
あくる	明くる	(后接年、月、日)明...,下...
あて		(寄、送、汇)给...，致...；(前接数量词)每...
いっさく	一昨	前(年，天...)
いっさんかたんそ	一酸化炭素	(化)一氧化碳
いまに	今に	一会儿，即将；最近，早晚，(到)现在，至今
いる		炒，煎
うつ	討つ	杀；(讨)伐，攻
え	柄	(器物的)柄，把儿
えび	蝦	虾
えんじる	演じる	扮演，干，做出
おい	甥	外甥，侄子
おろそか	疎か	马虎，草率，粗心大意
おん	御	表示敬意
かけ		表示动作未完成或中断
かっこ	括弧	括号；括起来
かようきょく	歌謡曲	通俗歌曲
カラー		色(彩)；颜料
かん	卷	书(本)；(书的)...卷
かんこく	韓国	韩国
ぎちょう	議長	(会议、团体等的)主席，议长
きっさ	喫茶	喝茶
きゃくご	客語	(语法)宾语
キャベツ		卷心菜，甘蓝
きゅうよ	給与	工资，津贴；供给，供应
くだり	下り	下，降；(列车的)下行
くらい	位	地位，职位；位数
くわだてる	企てる	计划，企图；打算，试图
けい	型	...型，...模型
けいこう	蛍光	萤火虫的光；荧光
けいこく	警告	警告
けっしょう	血漿	血浆
こうじつ	口実	借口，口实
こうど	光度	光度
ごうどう	合同	联合，合并
こうへい	公平	公平，公正
こうりょく	效力	効力，效果
さお		竹竿，竿子
さくせい	作製	制作，制造
しっぽ		尾巴，末尾
じつれい	実例	实例
じてん	事典	事典，百科词典
しゅう	洲	洲
じゅんじょう	純情	纯洁
しょうがくきん	奨学金	奖学金
しょうどく	消毒	消毒
じょおう	女王	女王
しょほ	初步	初步
スター		星(形)；明星
ずつう	頭痛	头痛；烦恼，忧虑
ぜいかん	税関	海关
せつぞく	接続	连接，接合
せん	栓	栓，塞(子)
せんざい	洗剤	洗涤剂
ぜんねん	前年	去年；前几年，前些年
せんめんき	洗面器	面盆，脸盆
たいわん	台湾	台湾
たつ	建つ	建，盖
ちゅう	注	注解，注释
つうこう	通行	通行，往来；通用，常用
つな	綱	缆绳，绳索
でし	弟子	弟子，徒弟
てぬぐい	手ぬぐい	布手巾
とく	溶く	溶(化)；溶合
ドル		美元
なかなおり	仲直り	和好，和解
なりゆき	成り行き	趋势，变化，结果
にがす	逃がす	放走；错过(机会)
ぬらす	濡らす	弄湿
はい	灰	灰
はいゆう	俳優	演员
はかり		秤
はかる	謀る	欺骗，谋算，谋求
バケツ		水桶
はげる		掉头发，秃
はなれる	放れる	解开
はら	原	平原，原野
びんぼうにん	貧乏人	穷人
ふごう	符号	符号，记号
ふさぐ	塞ぐ	不舒畅，郁闷；闭，堵塞
へん	遍	...遍,...回
へんしゅう	編集	编辑
ぼっちゃん	坊っちゃん	小宝宝，小朋友；少爷
ほり	堀	渠，沟；护城河
ミス		小姐，姑娘
むしば	虫歯	龋齿
めいじん	名人	名人
めぼしい		明显的，出色的；贵重的，值钱的
やくいん	役員	官员；董事
やくにん	役人	官吏
やじるし	矢印	箭形符号
よける	避ける	躲避，防备
よび	予備	预备，备品
れいとう	冷凍	冷冻
れんたいし	連体詞	(语法)连体词
わりあて	割り当て	分配，分摊；分担额(量)，分配的任务
めん	綿	棉制品，棉
そくたつ	速達	快信，快(递)件
かたづく	片付く	收拾整齐；处理好
かん	勘	灵机，直觉，第六感
あい	愛	爱
あいこうか	愛好家	爱好者
あいさつ	挨拶	寒暄
あいず	合図	暗号，记号
あいちゃく	愛着	眷恋
あいて	相手	对方，对手
あいどく	愛読	爱读，喜欢读
あかあかと	赤々と	熊熊
あかとんぼ	赤蜻蛉	红蜻蜓
あからさま		清楚，公开
あがる	上がる	上，进
あかるい	明るい	明亮
あきびん	空き瓶	空瓶
あきらか	明らか	明显
あきる	飽きる	腻，够，满足
あくい	悪意	恶意
あくしゅ	握手	握手
あくせく		辛辛苦苦
あける	明ける	天亮，新开始
あげる	挙げる	列举，举行，发动
あさい	浅い	浅
あさましい	浅ましい	卑鄙，下流
あさる	漁る	找食
アジア		亚洲
あしあと	足跡	足迹
あじきない	味気ない	乏味，无聊
あずかる	預かる	担任，管理
あずける	預ける	寄存，寄放
あせ	汗	汗
あたい	値	值，数值
あたえる	与える	给与，给以
あたり	辺り	一带，附近
あたる	当たる	适逢
あっとう	圧倒	压倒，凌驾
あつまる	集まる	聚集，聚会
あつめ	厚め	稍厚
あてがう	宛がう	分配，分给
アテネ		雅典
あてる	当てる	贴近，安，放
あと		后，以后，后面
あな	穴	洞，穴，孔
あなたがた		你们
あのまま		就那样
あぶら	油	油
アフリカ		非洲
あまのがわ	天の川	银河
あまりに		太，过于
あむ	編む	编织
アメリカ		美国
あらい	粗い	粗糙，稀疏
あらしやま	嵐山	岚山(地名)
あらそう	争う	争斗，斗争，竞争
あらゆる		所有，一切
あらわす	現す	出现
あらわれる	現れる	表现
ありあり		清清楚楚
ありがたい	有難い	难得，值得庆幸
ありったけ	有りったけ	所有，一切
あるいは		或，或是
あるきつづける	歩き続ける	持续步行
アルゼンチン		阿根廷
アルファベット		罗马字
あわい	淡い	淡的，浅的
あわせる	合わせる	合起，合并
～あわせる	~合わせる	互相
あわれむ	哀れむ	同情，怜惜
あんい	安易	容易
あんしょう	暗唱	背诵
いいかえる	言い換える	换句话说
いいだす	言い出す	说出
いいなおす	言い直す	重说，再说一遍
いいのこす	言い残す	留下话
いうまでもない	言うまでもない	不用说，当然
いえる	言える	能说，可以说
いき	意気	气势，气概
いきがい	生きがい	生存的意义
いきぐるしい	息苦しい	呼吸困难
いきづまる	行き詰まる	喘不上气
いくさ	戦	战争，战斗
いぐさ		灯心草
いくじ	育児	养育幼儿
いけだ	池田	池田(人名)
いける	活ける	揷，栽
いご	囲碁	围棋
いこう	以降	以后
#NAME?		等于
いし	医師	医生
いし	意志	意志
いしかわ	石川	石川(姓)
いしかわたくぼく	石川啄木	石川啄木(人名)
いしつ	異質	不同性质
いじゅつ	医術	医术
いしょく	異色	特色
いじわるい	意地悪い	心眼坏
いじん	偉人	伟人
いぜん	以前	以前
いそいそ		高高兴兴
いた	板	板
いだい	偉大	伟大
いだく	抱く	怀有，怀抱
いたみ	痛み	疼痛，苦恼
いち	位置	位置
いちい	一位	首位，第一
いちご		草莓
いちにんまえ	一人前	成人，一个人的份儿
いちぶ	一部	一部分
いちめんてき	一面的	片面的
いつか		不知不觉，曾经
いっかしょ	1か所	一处
いっきょ	一挙	一举
いつくしむ	慈しむ	怜爱，疼爱
いっしょ		一起
いっしょう	一生	一生
いっそう		更加
いっち	一致	一致
いってらっしゃい	行ってらっしゃい	走好
いっとき	一時	一时，暂时
いつぱい	一杯	一杯，满，全部
いっぺん	一遍	一遍
いつわり	偽り	谎言，虚伪
いてん	移転	迁移，搬家
いどう	異同	异同
いとぐち	糸口	线头，开端
いとしい		可爱，可怜
いにん	委任	委任
いぬ	犬	狗
いのうえ	井上	井上
いのち	命	生命
いまだに		仍然，尚
いまでは	今では	现在
いまや	今や	现在，已经
いやいやながら	嫌々ながら	勉强，不愿意
いやくしょ	医薬書	医药书
いよいよ		更，越发，终于
いらっしゃい		欢迎
いりょう	医療	医疗
いりょうひ	医療費	医疗费
いれかえる	入れ替える	换，改换
いれかわる	入れ代わる	替换，交换
いろは		初步，入门
いろり		地炉，炕炉
いわい	祝い	喜庆，庆贺
いわう	祝う	庆祝，祝贺
いわてけん	岩手県	岩手县
いんが	因果	因果
インク		墨水
いんよう	引用	引用
ほうふ（だ）	豊富	丰富
ホーム		家庭，
ボート		小船，小艇
うえ	飢え	饥饿
ウエーター		(餐厅等的)男服务员
ウエートレス		餐厅等的)女服务员
うえき	植木	庭院的树木，盆栽
うかがう	伺う	拜访
うかびあがる	浮かび上がる	浮起，漂起
うかぶ	浮かぶ	漂，浮，呈现
うけとる	受け取る	收下
うけもつ	受け持つ	担任，担当
うごかす	動かす	活动，转动
うし	牛	牛
うしかい	牛飼い	放牛，牛倌
うしなう	失う	丧失，失去
うすまる	薄まる	变淡
うすめる	薄める	稀释
うだる	うだる	热得浑身发软
うちあげ	打ち上げ	发射
うちだ	内田	内田
うちとける	打ち解ける	融洽
うちひしがれる		打垮
うちゅうひこうし	宇宙飛行士	宇航员
うちょうてん	有頂天	欣喜若狂
うつす	移す	迁，移，变动
うっかり		出神，心荡神驰
うどんじる	疎んじる	疏远，冷淡
うなる		呻吟，吼叫
うねる		弯曲，蜿蜒
うばう	奪う	剥夺，夺走
うま	馬	马
うまれこきょう	生まれ故郷	故土
うまれそだつ	生まれ育つ	生养
うむ	有無	(明确表示要)可否
うめ	梅	梅树，梅花
うめく		呻吟
うもれる	埋もれる	埋上，埋下
うやまう	敬う	敬，尊敬
うらおもて	裏表	正反面，表里
うらやましい		令人羡慕
うらやむ		羡慕
うるおす	潤す	润，湿
うれえる	憂える	担心，忧虑
うわのそら	上の空	心不在焉
え		哦
えいきょう	影響	影响
えいせい	衛生	卫生
えいぞく	永続	持久
えいよう	栄養	营养
ええと		嗯
えかき	絵描き	画家
エジソン		爱迪生
エジプト		埃及
えしゃく	会釈	点头，打招呼
SF（エスエフ）		科幻小说
えっ		哎
えど	江戸	江户
えとく	会得	领会，理解
えのぐ	絵の具	绘画颜料
えらい	偉い	伟大，了不起
える	得る	得到，获得
LSI（エルエスアイ）		大规模集成电路
えん	円	日元
えんげい	園芸	园艺
エンジンつき	エンジン付き	装有发动机(的)
おあがり		请进
おいたち	生い立ち	成长
おいはらう	追い払う	轰走，赶走
おう	王	王
おう	追う	追
おうふく	往復	往返
おうべいふう	欧米風	西洋式
おおきめ	大きめ	稍大
おおじしん	大地震	大地震
おおどおり	大通り	大马路，大街
おおはばに	大幅に	大幅度
おおむね	概ね	大约，大致
おおめ	多目	稍多
おおや	大家	房东
おかず		菜
おかだ	岡田	冈田
おがむ	拝む	拜，叩拜
おかやま	岡山	冈山
おかゆ		粥
おきあがる	起き上がる	起来，站起来
おきかえる	置き換える	变换位置
おく	奥	里头，内部，深处
おくる	贈る	赠送
おこす	起こす	发生，引起
おこたる	怠る	怠慢，懒惰
おこる	起こる	发生
おさえる	押える	按住
おさない	幼い	幼小，幼年
おさまる	納まる	收纳，平定，平息
おしい	惜しい	可惜，遗憾
おしまい	御仕舞い	完了，最后
おせわになりました	お世話になりました	给您添麻烦了
おそらく	恐らく	恐怕，大概
おそれる	恐れる	害怕，担心
おそろしい	恐ろしい	可怕，惊人
おだいじに	お大事に	请多保重
おたがい	お互い	互相
おちる	落ちる	掉，落
おっ		噢
おっと	夫	丈夫，爱人
おとす	落とす	失落，丢掉，遗失
おととい	一昨日	前天
おととし	一昨年	前年
おとなしい		温顺
おに	鬼	鬼
おはよう（ございます）		您早
おぼん	お盆	盂兰盆节
おまえたち		你们
おまけに		而且，再加上
おもいきって	思い切って	下决心，断然
おもいきり	思い切り	尽情
おもいで	思い出	回忆
おもいのほか	思いのほか	意外，没想到
おもかげ	面影	影像，面貌
おもたい	重たい	沉重
おもな	主な	主要的
おもに	重荷	重载，重货
おもはゆい		害躁
おもに	主に	主要
おや	親	父母，双亲
おやこ	親子	父母和子女，父子，母子
おやこうこう	親孝行	孝顺双亲
およめさん	お嫁さん	妻子
オランダ		荷兰
おりあげる	織り上げる	织成
おりがみ	折り紙	折纸
おりひめ	織姫	织女
おる	折る	折
おれたち		我们
おわる	終わる	结束，完
おんくん	音訓	音训
おんせつ	音節	音节
おんど	温度	温度
おんどく	音読	音读
か	課	课
かい		(男性用语)表示疑问
かい	会	会
かいかい	開会	开会
がいかん	概観	概观
かいぎ	懐疑	怀疑
かいけつ	解決	解决
がいけん	外見	表面，外表
がいこう	外交	外交
がいこくご	外国語	外语
かいこん	悔恨	悔恨
がいして	概して	一般，大体上
がいしゅつぎ	外出着	出门穿的衣服
かいじょう	海上	海上
かいすいよく	海水浴	海水浴，海水游泳
かいそう	回想	回想
かいつう	開通	通车
かいてん	開店	新商店开市
かいどうぞい	街道沿い	沿路
かいとる	買い取る	买过来
かいひ	回避	回避
かいめい	解明	解释明白
カイロ		开罗
かえす	帰す	让……回去
かえりみる	顧みる	回顾
かえる	返る	复原，复归
かおく	家屋	住房
かおぶれ	顔ぶれ	参加的人，成员
がか	画家	画家
かがく	化学	化学
かがむ	屈む	弯腰，蹲下去
かがやく	輝く	放光(辉)
かかり	係り	担任(某工作)，担任者
かかる	係る	关联
かぎ	鍵	钥匙
かきあげる	書き上げる	写出，写成
かきあらわす	書き表す	写出来
かきうつす	書き写す	抄写
かきおえる	書き終える	写完
かきくわえる	書き加える	加写，添写
かきことば	書き言葉	书面语
かきこむ	書き込む	写上，填写
かきじゅん	書き順	笔顺
かきだす	書き出す	摘录，开始写
かきて	書き手	写的人
かきとめる	書き留める	记下
かきとり	書き取り	听写
かきなおす	書き直す	改写
かきね	垣根	篱笆，栅栏
かきぶり	書き振り	运笔的姿势，笔迹
かぎょう	家業	家业
かぎり	限り	只要~
かぎりない	限りない	无限
かぎる	限る	限定，限于
がくい	学位	学位
かくいつ	画一	划一，统一
かくえきていしゃ	各駅停車	每站停车
かくじつ	確実	确实
がくしゅう	学習	学习
かくすう	画数	(汉字的)笔划数
がくせいふく	学生服	男学生校服
がくぜん	愕然	愕然
かくて		于是，这样
がくねん	学年	学所
がくようひん	学用品	学习用品
かくりつ	確率	概率
かくれる	隠れる	躲，躲藏
かげ	陰	日阴，背光处
かけごえ	掛け声	号子，助威声
かける	掛ける	悬挂
かこい	囲い	围子
かこう	下降	下降
かこう	火口	火山口
かこむ	囲む	围
かさい	火災	火灾
かささぎ		喜鹊
かさなる	重なる	装饰，修饰，摆设
かし	菓子	点心
かしこまりました		知道了
かしだす	貸し出す	出借，出租
かしょ	か所	~个地方
かしょ	箇所	地方，处，位置
かす	糟	渣滓
かず	数	数
ガス		煤气
かすれる	掠れる	掠过
かぜ	風邪	感冒
かぞえる	数える	数
かた	肩	肩，膀子
がた(がた)		们(敬称)
ガタガタ		哗哗
かたまる	固まる	巩固
かため	固め	稍硬
かたりつたえる	語り伝える	流传
かたりて	語り手	说话的人
かち	価値	价值
かちょう	課長	科长
がつ	月	~月
がっかり		失望
かっき	活気	朝气
がっき	楽器	乐器
かつどう	活動	活动
かつりょく	活力	活力
かてい	家庭	家庭
かてい	課程	课程
かとき	過渡期	过度期
かな	仮名	假名
かなづち	金槌	铁锤
かならずしも		不一定
かなり		相当
かねて		事先，以前
かねる	兼ねる	兼，兼带
かび		霉
かぶ	株	股份，股票
かぶる	被る	戴
かま	鎌	镰
かまいません		没关系，不要紧
かまう	構う	介意
かまくら	鎌倉	镰仓
がまん	我慢	忍耐
かみ	神	神
かみくず	紙くず	纸屑，废纸
かみさま	神様	神仙，上帝
かみしばい	紙芝居	连环画剧，(拉)洋片
かみひとえ	紙一重	微小
かむ	噛む	嚼
かもく	科目	科目，项目
カモメ		海鸥
かゆい	痒い	痒
からこそ		正因为
からまわり	空回り	空转
かりゅう	下流	下游
かる	狩る	打猎
カレーライス		咖喱饭
かれる	枯れる	枯萎
かわ	皮	皮
がわ	側	~侧，~方面
かわいそう	可哀相	可怜
かん	缶	罐
かんがえだす	考え出す	想出
かんき	喚起	唤起
かんげい	歓迎	欢迎
かんげき	感激	感激，感动
かんげき	観劇	观剧，看戏
かんけつ	完結	完结，完毕
かんこうきゃく	観光客	游客
かんさつ	観察	观察
かんじ	感じ	感觉
かんしゃ	感謝	感谢
かんじゃ	患者	病人，患者，病号
かんしょう	感傷	伤感
かんしん	感心	赞成，赞叹
かんぜん	完全	完全
かんそう	感想	感想
かんちがい	勘違い	理解错
かんちく	含蓄	含蓄
かんどうし	感動詞	感叹词
かんとうだいしんさい	関東大震災	关东大地震
かんねん	観念	观念
がんばる	頑張る	努力，奋斗
かんびょう	看病	看护，护理
がんぼう	願望	愿望
かんむり	冠	冠
かんめい	感銘	铭记，感动
かんやく	簡約	简化
かんりゃく	簡略	简略
かんりょう	完了	完了
かんわじてん	漢和辞典	汉和字典
ぎ	着	~(服)装
きあつ	気圧	气压
きおく（する）	記憶	记忆
ぎおん	擬音	拟声
ききゃく	棄却	抛弃，不采纳
ききゅう	気球	气球
きげん	期限	期限
きげん	機嫌	情绪，问候
きこう	気候	气候
ぎしき	儀式	仪式
きしょう	起床	起床
きしょうちょう	気象庁	气象厅
ぎじんほう	擬人法	拟人法
きず	傷	伤
きずきあげる	築き上げる	缔造
きする	期する	确信
きせい	既成	既成
きせい	帰省	回乡省亲
ぎせい	擬声	拟声
ぎせいご	擬声語	拟声词
きせき	軌跡	轨迹
きそ	基礎	基础
きそいあう	競い合う	互相竞争
ぎたい	擬態	拟态
ぎたいご	議題語	似态词
きちょう	貴重	贵重
きちょうめん		一丝不苟
きちんと		准确，不多不少
ぎっしり		满满的
きどる	気取る	装腔作势
きねん	記念	纪念，留念
きのどく	気の毒	可怜，悲惨
きぼう（する）	希望	希望
きまる	決まる	定，决定
きみ	気味	心情，情绪
きみたち	君達	你们
ぎむ	義務	义务
きむら	木村	木村
ぎゃく	逆	相反
ぎゃくせつ	逆説	似非而是的说法
きゃっかんてき	客観的	客观
きゅうか	休暇	休暇
きゅうきゅう	救急	急救
きゅうけい	休憩	休息
きゆうこう	休講	停讲，停课
きゅうめい	究明	研究明白
きゅうよう	休養	休养
きょう	京	京(京都的旧称)
ぎょう	行	行
きょうかしょ	教科書	教科书，教材
きょうぎ	協議	协议
きょうさんしゅぎ	共産主義	共产主义
きょうさんとう	共産党	共产党
きょうし	教師	老师
ぎょうし	凝視	凝视
ぎょうじ	行事	活动
きょうちょう	強調	强调
きょうつうご	共通語	普通语，通用语
きょうりょく	協力	合作
ぎょぎょう	漁業	渔业
きょく	極	极
きょこう	虚構	虚构
きょだい	巨大	巨大
きよみずのぶたい	清水の舞台	清水寺的舞台
きょり	距離	距离
きり	霧	雾
きりつ	規律	规律
きれ		小片，布头
きろく	記録	记录
キログラム		公斤，千克
きわ	際	边际，~的时候
きわまる	極まる	达到极限
きん	金	金
ぎん	銀	银
きんき	近畿	近畿
きんし	禁止	禁止
きんとう	均等	均等
きんねん	近年	近年
ぐ	具	菜码
クアラルンプール		吉隆坡
くうきょ	空虚	空虚，空洞
クーラー		冷气设备
くぎる	区切る	隔开
くくる	括る	捆，扎，绑
くさい	臭い	臭
くし		梳子
くじく	挫く	挫，扭
くじける	挫ける	沮丧，颓唐
くじょう	苦情	意见
くすぐる	擽る	搔，逗哏
くすぶる	燻る	冒烟
くせ	癖	癖，习气，脾气
ぐたいてき	具体的	具体
くだく	砕く	弄碎
くだける	砕ける	破碎，平易近人，浅近易懂，随便的
くちぐせ	口癖	口头语
くちばし	嘴	鸟嘴
くちべに	口紅	口红
くったく	屈託	顾虑，操心
くっつく		挨着，接合
くつろぐ	寛ぐ	舒适，舒畅
くてん	句点	句号
くどい		絮叨
くとうてん	句読点	句号，逗号，标点符号
くのう	苦悩	苦恼，痛苦
くばる	配る	发，分送
くふう（する）	工夫	动脑筋，想办法
くべつ	区別	区别
くみ	組	组，班
くみあわせ	組み合わせ	组合
くむ	汲む	汲(水)，打(水)
くもり	曇り	阴，阴天
くやしい	悔しい	悔恨
グライダー		滑翔机
くらしはじめる	暮らし始める	开始生活
くらす	暮らす	生活，度日
クラスメート		同学
くらべものにならない	比べ物にならない	无法比拟
くらむ	眩む	眼花
くりかえす	繰り返す	反复
くるしい	苦しい	苦
くれぐれも		反复请求
くろう（する）	苦労	辛苦，吃力
くわえる	加える	加，施加
くわしい	詳しい	详细
くん	訓	训读
ぐん	軍	军队
け	毛	毛
けいい	敬意	敬意
けいこう	傾向	倾向
けいざいりょく	経済力	经济力量
けいさつかん	警察官	警察
けいさん（する）	計算	计算
けいじ	掲示	布告，揭示
けいしき	形式	形式
げいじゅつ	芸術	艺术
けいしょう	継承	继承财产
けいじょう	計上	计入，列入
けいふく	敬服	佩服
けいやく	契約	契约，合同
けいゆ	経由	经过，途经
けいりぶ	経理部	财会部门
げき	劇	剧
げこう	下校	放学
けしかける		唆使
けしゴム	消しゴム	橡皮
けじめ		区别，差别
けしわすれる	消し忘れる	忘记弄灭
げすい	下水	脏水，污水
けずる	削る	削
けた	桁	栋梁，位数
けつきょく	結局	结果，归根到底
けっしん	決心	决心
けっせき	欠席	缺席
けつだん	決断	果断，决心
けってい	決定	决定
けってん	欠点	缺点
けねん	懸念	担心，悬念
けむり	煙	烟，烟雾
ける	蹴る	踢
けん	兼	兼
けんがく	見学	参观
けんきょ	謙虚	谦虚
けんこう	健康	健康
げんごがく	言語学	语言学
けんさ	検査	检查
げんじゅう	厳重	严重
げんしりょく	原子力	原子能
けんせつ	建設	建设
げんそうてき	幻想的	具有幻想色彩
げんだい	現代	现代
けんちく	建築	建筑
けんちょ	顕著	显著，明显
けんちょう	堅調	行情上涨
けんぶん	見聞	见闻
けんぶんをひろめる	見聞を広める	长见识，扩大眼界
けんぽう	憲法	宪法
けんめい	懸命	贤明
げんめい	言明	言明，说清
けんり	権利	权利
げんりょう	原料	原料
こい	濃い	浓，深，密
こいびと	恋人	恋人，情人，对象
コイン		硬币
ごう	合	~合（一合约为0.18公斤）
ごうい	合意	同意，意见一致
こううん	幸運	幸运
こうえん	後援	后援
こうえん	講演	讲演
こうおう	呼応	响应，响应
こうかい	公開	公开
こうがい	公害	公害
こうかてき	効果的	有效果
こうかん	好感	好感
こうかん	交換	交换
こうかんしゅ	交換手	接线员
ごうけい	合計	合计
こうごう	皇后	皇后
こうこく	広告	广告
こうさく	交錯	交错
こうさん	降参	投降
こうさん	公算	可能性
こうし	行使	行使
こうじ	工事	工程
こうした		这种，这样的
こうしゃ	後者	后者
こうしゅう	公衆	公众，大众
こうせい	攻勢	攻势
こうせい	恒星	恒星
こうせい	厚生	福利保健
こうそう	高層	高层
こうそく	高速	高速
こうだい	広大	辽阔，宏大
こうち	耕地	耕地
こうつりょう	交通量	交通量，通行量
こうてい	皇帝	皇帝
こうどう	行動	行动
こうふう	校風	校风
こうふく	幸福	幸福
こうよう	効用	用处，效能
こうよう	紅葉	红叶
ごうりてき	合理的	合理
こうりゅう	交流	交流
こうれい	高齢	高龄
ごうれい	号令	号令，口令
こえる	超える	超过
こえる	肥える	胖，肥
コーチ		教练
コーヒー		咖啡
こおり	氷	冰
ごがく	語学	外语(学习)
こかげ	木陰	隐蔽处
こがらし	木枯らし	寒风
ごかん	語感	语感
ごかん	五感	五种感觉
ごきげんよう		您好，一路平安
こきゅう	呼吸	呼吸
こくごじてん	国語辞典	国语词典
こくさいしゅぎ	国際主義	国际主义
こくせいちょうさ	国勢調査	国情调查
こくばん	黒板	黑板
こくほう	国宝	国宝
こくれんじむそうちょう	国連事務総長	联合国秘书长
こころづかい	心遣い	关怀，照料
こころづくし	心尽くし	好意，费习
こじゅうおく	50億	50亿
こしをぬかす	腰をぬかす	惊呆
こじんてき	個人的	个人的
こす	越す	越，过，渡
こそ		才是，才能
こたい	個体	固体
こたえ	答え	回答
ごちそうさまでした	ご馳走様でした	吃好了，吃饱了
こちらこそ		哪儿的话
こづかい	小遣い	零花钱，零用钱
こっきょう	国境	国境
コック		厨师
こっせつ（する）	骨折	骨折
こづつみ	小包	包裹，邮包
ことさら	殊更	故意，特意
ことのほか	殊の外	格外
ことばづかい	言葉使い	措词，说法
ことわり	断り	拒绝
こなれる		消化，熟练
こにんまえ	5人前	5个人的份儿
このあいだ	この間	前些日子，以前
このごろ	この頃	最近
このは	木の葉	树叶
このまま		就这样
こぶ		瘤子，包
ごぶさた	御無沙汰	久未访问，久未通信
こぼす	零す	弄洒，洒掉
こま		陀螺
こまごま	細々	零碎，详细
こみあう	込み合う	人多，拥挤
こみあげる	込み上げる	往上涌，涌现
ゴム		橡胶
ごもくずし	五目ずし	什锦寿司饭
こもん	顧問	顾问
こやす	肥やす	使。。。肥胖
ごようけん	御用件	事，事情
こらしめる	懲らしめる	惩罚
コラム		专栏
これなら		这样一来
これほど		这种程度，如此
これら		这些
ごろ	頃	~时候，~时分
こわばる		发硬，变硬
こんげん	根源	根源
こんせいき	今世紀	本世纪
こんせん	混戦	混战
こんなん	困難	困难
さ	差	差别
サービス		服务
さい	差異	差异
サイクリング		自行车旅行
さいげつ	歳月	岁月
さいしょう	最小	最小
さいする	際する	当~之际
さいだい	最大	最大
さいだん	裁断	剪裁，裁断
さいてん	採点	评分
さいのう	才能	才能
さいばんしょ	裁判所	法院
ざいりょう	材料	用料，材料
さいわい	幸い	幸运
さえ		连，甚至
さか	坂	坡，斜坡
さかさま	逆さま	倒，逆
さがしつづける	探し続ける	继续寻找
さがしまわる	捜し回る	到处找
さかり	盛り	盛期
さがる	下がる	下降
さきだつ	先立つ	站在前头，带头
さく	裂く	撕开，切开
さくいん	索引	索引
さくしゃ	作者	作者
さくじょ	削除	消除，删掉
さくねん	昨年	去年
さくひん	作品	作品
サグレブし	サグレブ市	萨格勒布市
さけ	酒	酒
さける	避ける	避免
ささる	刺さる	扎进，刺入
さしえ	挿絵	插图
さしがね	差し金	教唆，唆使
ざしき	座敷	（铺草席的日本式的）房间
さしこむ	差し込む	插，扎进
さそいだす	誘い出す	约出
さそう	誘う	邀请
サッカー		足球
サッカーボール		足球
さっそく	早速	立刻，马上
ざっと		粗略,简略
さっとう	殺到	涌向，蜂拥而至
さて		那么，且说，却说
さなか		最高潮
さま	様	接在姓名后表示尊敬
さまざま	様々	各种各样
さめる	覚める	醒
さやえんどう	莢豌豆	嫩豌豆角
さゆう	左右	左右，支配
さようなら		再见
さらに		还要，进而
さる	猿	猴子
さわぎ	騒ぎ	骚乱，混乱
さんか	参加	参加
さんかく	三角	三角
さんかくけい	三角形	三角形
さんかしゃ	参加者	参加者
さんかん	参観	参观
さんぎょう	産業	产业
さんこう	参考	参考
さんごう	3合	3合（一合大约为0。18公升）
さんざん		厉害，严重
ざんしょ	残暑	残暑，秋老虎
さんせい	賛成	赞成
サンダツ		凉鞋
さんたん	賛嘆	赞叹
サンパウロ		圣保罗
し	市	市
し	士	~员，~士
じ	時	时，点
しあわせ	幸せ	幸福
しいたけ		香菇
しいん	子音	辅音
しおり		书签
じか	自家	自己家，自我
しかく	四角	四方
じかく	字画	笔画
しかくけい	四角形	四方
しかも		而且
しかる	叱る	责备，斥责
じかんわり	時間割	时间表
しき	四季	四季
しき	式	仪式，典礼
しきい	敷居	门槛，门坎
じきに		立即，马上
しく	敷く	铺设
じけい	字形	字形
しさ	示唆	暗示，启发
しさく	思索	思索
じじつ	事実	事实
ししゃ	使者	使者
ししゅう	詩集	诗集
じじょう	事情	情况
ししん	指針	指针
しすう	指数	指数
しずみかける	沈みかける	要沉
しずむ	沈む	沉，落
しせつ	使節	使节
しせん	視線	视线
じそく	時速	时速
した	舌	舌头
じだいおくれ	時代遅れ	落后于时代
したがう	従う	遵从，适应
したがき	下書き	试写，草稿
したがって		因此
したしい	親しい	亲密
じち	自治	自治
しつ	質	质，质量
じっかん	実感	实感
しっけ	湿気	湿气
じっけん	実験	实验
じっけんだい	実験台	实验台
じつげん	実現	实现
じっさい	実際	实际
じつざい	実在	实在存在，实在
じっしょう	実証	证实，证据
じっしんほう	十進法	十进制
じつぶつ	実物	实物
じつようか	実用化	实用化
しつれいします	失礼します	对不起,失礼
していせき	指定席	对号入座
じてん	時点	时候
しどう（する）	指導	指导
じどうてき	自動的	自动
しとしとと		淅淅沥沥
しのぶ	忍ぶ	暗中做，隐藏
しはい	支配	统治
しばい	芝居	戏，戏剧
しはらい	支払い	支付
しばる	縛る	捆，绑，扎
じばん	地盤	地面，地基，地盘
じひ	慈悲	慈悲
しひ	詩碑	诗碑
しほう	四方	四方，四面
じほう	時報	报时
しぼむ	萎む	枯萎
しぼる	絞る	拧，挤
しほん	資本	资本
しみず	清水	清水
しみとおる	染みとおる	渗透
しめきり	締め切り	截止
しめす	示す	表示
しめだす	閉め出す	关在外面
しも	霜	霜
しゃ	社	~社
じゃがいも		土豆
ジャカルタ		雅加达
じゃくてん	弱点	弱点
しゃくど	尺度	尺度，标准
しゃくほう	釈放	释放
しゃせい	写生	写生
しゃべる	喋る	谈，说，聊
じゃま	邪魔	妨碍，访问
しゃれ	洒落	打扮漂亮
じゃんけん		划拳
しゅ	種	~种
しゅい	首位	首位
しゅう	週	星期，周
しゅうい	周囲	周围
じゅうおう	縦横	纵横
しゅうおんらい	周恩来	周恩来
しゅうかん	週間	~周，星期
しゅうぎ	衆議	众议
しゅうさい	秀才	秀才
しゅうじ	習字	习字
しゅうしょくご	修飾語	修饰语
ジュース		果子汁
じゆうせき	自由席	(电车等)不对号的座位
しゅうせきかいろ	集積回路	集成电路
しゅうぜん	修繕	修缮，修理
じゅうぞく	従属	从属
じゅうたい（する）	渋滞	阻塞
しゅうち	周知	人所共知
しゅうち	羞恥	羞耻
じゅうてん	重点	重点
しゅうにゅう	収入	收入
しゅうにん	就任	就任
しゅうへん	周辺	周围
じゅうよう	重要	重要
しゅうろく	収録	收录
しゅかんてき	主観的	主观
じゅくご	熟語	汉语词，复合词
しゅくしょう	縮小	缩小
じゅくす	熟す	熟，成熟
しゅくはく	宿泊	住宿
しゅこう	趣向	趣旨
しゅじゅつ	手術	手术
じゅしょう	受賞	得奖，获奖
しゅじん	主人	丈夫
しゅたいせい	主体性	独立见解
じゅだく	受諾	接受
じゅちゅう	受注	接受订货
じゅつご	術語	术语
じゅどう	受動	被动
ジュネーブ		日内瓦
じゅよう	需要	需要
しゅるい	種類	种类
じゅん	順	顺，顺序
しゅんかんてき	瞬間的	循环
じゅんじょ	順序	顺序
しょう	使用	使用
しょう	賞	奖
しょう	省	(日本内阁的)省
じょうえい	上映	上演
じょうえつ	上越	上越
しょうか	消化	消化
しょうか	消火	灭火
しょうがくせい	小学生	小学生
じょうき	蒸気	蒸气
しょうぎょう	商業	商业
しょうきょくてき	消極的	消极
じょうけい	情景	情景
じょうけん	条件	条件
じょうこう	条項	条款，项目
しょうじき	正直	老实，正直
じょうしき	常識	常识
じょうしゃけん	乗車券	车票
しょうじょ	少女	少女
しょうしょう	少々	稍微
しょうじょう	賞状	奖状
しょうせちか	小説家	小说家
じょうたい	常体	简体
じょうたつ	上達	进步，长进
しょうてん	商店	商店
しょうねん	少年	少年
しょうはい	勝敗	胜败
しょうひん	商品	商品
しょうひん	賞品	奖品
じょうひん	上品	文雅，高尚，上等货
しょうべん	小便	小便
しょうぼうし	消防士	消防队员
しょうもう	消耗	消耗
しょうゆ	醤油	酱油
じょうりゅう	上流	上流，上游
しょきゅう	初級	初级
じょきょ	除去	除去
しょくぶつ	植物	植物
しょくぶつせい	植物性	植物性
しょくもつ	食物	食物
じょし	女子	女子
しょしゃ	書写	书写
じょじょに	徐々に	逐渐地
しょしん	初心	初衷
しょたい	書体	字体
しょっかく	触角	触角
しょっぱい		咸
しょめい	書名	书名
じょゆう	女優	女演员
しらせ	知らせ	通知
しりあい	知り合い	熟人，友人
しりとり	しり取り	(游戏)接尾令
しりめ	しり目	斜眼看
しるし	印	标志
しれる	知れる	被人知道
しわざ	仕業	所作的事情
じんいん	人員	人员
しんえい	新鋭	新生力量
しんきょう	心境	心境，心情
しんくうかん	真空管	真空管
しんけん	真剣	认真
じんけん	人権	人权
しんこきゅう	深呼吸	深呼吸
じんじ	人事	人事
しんしつ	寝室	卧室
しんしょく	侵蝕	侵蚀，侵占
しんじる	信じる	相信
じんせい	人生	人生
しんしん	心身	身心
しんせき	親戚	亲戚
しんぞう	心臓	心脏
しんたい	身体	身体
しんたく	信託	信托，委托
しんちょう	身長	身长，身高
しんど	震度	震级
しんとう	神道	(日本)神道
しんぽ（する）	進歩	进步，提高
シンボル		象征
じんるい	人類	人类
しんろ	進路	出路，前进的道路
ず	図	图，~图
すいい	推移	推移
すいこう	推敲	推敲
すいこむ	吸い込む	吸进
すいさんぶつ	水産物	水产
ずいじ	随時	随时，时常
すいじょうき	水蒸気	水蒸气
すいてい	推定	推定
すいとる	吸い取る	吸收
すいぶん	水分	水分
すいりょく	水力	水力
すう	数	数~
すうじ	数字	数字
すうち	数値	数值
すうにん	数人	数人
スープ		汤
すえっこ	末っ子	最小的孩子
すがすがしい	清清しい	清新，清爽
すがた	姿	姿态，装束，身影，样子
ずかん	図鑑	图鉴
すぎ	過ぎ	过了，超过
すくう	救う	救，求救
すくない	少ない	少
すぐれる	優れる	优秀，出色
スケッチ		速写
ずこう	図工	手工
すこぶる	頗る	非常，很
ずしき	図式	图解，图式
すず	鈴	铃，铃铛
すすむ	進む	进步，先进
すすめる	進める	前进，进行，开展
すすめる	勧める	劝
スチュワーデス		空中小姐
ずつ		(表示平均的意思)每……
ずっと		(比)~得多
すっぱい		酸
すなお	素直	天真，纯朴
すね	脛	胫部
すばらしい	素晴らしい	极好,出色
スピーチ		讲话，演讲
すべて		全部，一切
すべる	滑る	滑，滑溜
すぼむ	窄む	细窄
すます	澄ます	使清澈
すみび	炭火	炭火
すみません		请问，对不起
すもう	相撲	摔跤
すりむく	擦りむく	擦破
する	擦る	擦
する	刷る	印刷
ずるい		狡猾
するどい	鋭い	尖锐
すれちがう	擦れ違う	擦过去，走两岔
せい	精	精力
せい	性	性，性别，本性；~性
せいあん	西安	西安
せいい	誠意	诚意
せいおん	清音	清音
せいこう（する）	成功	成功
せいさん	生産	生产
せいしつ	性質	性质
せいしょ	清書	誊清
せいじん	成人	成人
せいしん	精神	精神
せいぜい		最多不过~
せいせき	成績	成绩
せいたい	生態	生态
ぜいたくひん	ぜいたく品	奢侈品
せいど	精度	精确度
せいど	制度	制度
せいとん	整頓	整顿
せいねん	青年	青年
せいび	整備	备齐，铺设
せいひん	製品	制品，产品
せいふ	政府	政府
せいぶつ	生物	生物
せいめい	生命	生命
せいり	整理	整理
セーラーふく	セーラー服	水兵服式的女学生制服
せき	咳	咳嗽
せきたん	石炭	煤炭
せきとめる	せき止める	堵住
せきにんかん	責任感	责任感
せきゆ	石油	石油
せきりょう	寂寥	寂寞，冷清
せく	急く	急，着急
せっかく		好不容易
せっきょくてき	積極的	积极
せっきん	接近	接近
せっけいず	設計図	设计图
せっけん	石鹸	肥皂
ぜったいに	絶対に	绝对
ぜっちょう	絶頂	顶峰
せつび	設備	设备，设置
せとないかい	瀬戸内海	濑户内海
せのび	背伸び	伸腰，踮脚
せりふ	台詞	台词
ぜん	善	善，好事
ぜんい	善意	善意，好意
ぜんけん	全権	全权
ぜんこう	全校	全校，所有的学校
ぜんこく	全国	全国
ぜんしゃ	前者	前者
せんしゅ	選手	选手
ぜんしん	全身	全身，浑身
せんぞく	専属	专属
せんたく	選択	选择
せんたん	先端	尖端
センチ		~厘米
センテンス		句子
せんにゅうかん	先入観	先入为主，成见
せんろ	線路	线路，轨道
そう	総	总~
そうあん	草案	草案
そういえば	そう言えば	这么说
ぞうお	憎悪	憎恶
そうか		是啊
そうぎょう	操業	操用，作业
ぞうげん	増減	增减
そうさ	操作	操作
そうさく	創作	创作
そうした		这种，这样的
そうじんこう	総人口	总人口
そうたい	早退	早退
そうだんにのる	相談に乗る	帮人斟酌
そうてい	想定	假想，设想
そうりょう	送料	邮费
ソウル		汉城
そがい	疎外	疏远，冷淡
そこ	底	底部
そこく	祖国	祖国
そこで		因此
そしき	組織	组织
そせん	祖先	祖先
そそっかしい		冒失，轻率，慌张
そだつ	育つ	生长
そのうえ	その上	并且
そのかわり	その代わり	取而代之，反面
そのご	その後	后来，以后
そのた	その他	其他
そのため		因此
そのまま		就那样
そらす	逸らす	岔开，离开
それこそ		那才，那正是
それぞれ		各自
それだけ		相应地
それでも		即便如此
それとも		还是~
それなのに		尽管这样
それら		它们
それる	逸れる	偏离(目标，方向)
そろう	揃う	齐全
そん	損	损失
そんけい（する）	尊敬	尊敬
そんざい	存在	存在
だい	台	~辆
だい	第	第~
たいい	大意	(文章的)大意
だいがんとう	大雁塔	大雁塔
たいきん	大金	巨款
だいく	大工	木工，木匠
だいざい	題材	题材
だいさんかい	第三回	第三次
たいした		了不起
たいしつ	体質	体质
たいして		不怎么
たいしょう	大正	大正(年号)
たいじょう	退場	退场，下场
たいする	対する	对
たいせい	大成	完成
たいそう	体操	体操
だいたすう	大多数	大多数
たいど	態度	态度
たいはん	大半	大半，过半
たいべつ	大別	大致的区别
だいめい	題名	标题，题名
だいめいし	代名詞	代词
だいもく	題目	题目
だいもんじやき	大文字焼き	大字形的篝火
たいよう	太陽	太阳
たうえ	田植え	插秧
たえぬく	耐え抜く	经得起
タオル		毛巾
たかい	高い	高，高的
たがいに	互いに	互相
たかぶる	高ぶる	兴奋，高傲
たから	宝	宝物，宝贝
たき	滝	瀑布
たきあがる	炊き上がる	煮好
だくおん	濁音	浊音
たくする	託する	托，委托
だくてん	濁点	浊音符号
たぐる	手繰る	拉近
たけ	竹	竹子
だけど		但是
たけのこ	筍	笋
たしかめる	確かめる	确认
だしじる	出し汁	用海带、木鱼等煮的高汤
たしなむ	嗜む	爱好，嗜好
たすける	助ける	救助，帮助
たずさえる	携える	携带，偕同
たずねる	尋ねる	询问
ただ		只，仅
ただいま		我回来了
たたかう	戦う	战斗
たたく	叩く	敲
ただでさえ		本来就，平常就
たちどまる	立ち止まる	站住，止步
たちば	立場	立场
たつ	断つ	切开，断，截
たつ	経つ	经，过(时间)
たなかし	田中氏	田中氏
たなばた	七夕	七夕
たね	種	种子；原因
たねあかし	種明かし	揭开秘密
たねまき	種まき	播种，撒种
たのしむ	楽しむ	欣赏
たべすぎ	食べ過ぎ	吃得过多
たま	玉	玉石，球，灯泡
だまりこむ	黙り込む	沉默，无言
だまる	黙る	沉默，无言，不说话
たよる	頼る	靠，依靠
だらしない		不检点，吊儿郎当
たらず	足らず	不足~
たる	足る	足，够，值得
たわら	俵	稻草包
だん	段	楼梯，台阶
たんきゅう	探求	探求，探索
たんご	単語	单词
だんじょ	男女	男女
たんすう	単数	单数
だんぜつ	断絶	断绝，绝灭
だんちょう	団長	团长
たんにん	担任	担任，担当
たんぶん	短文	短文
だんぺん	断片	片断，部分
だんらく	段落	段落
ち	値	~值
ちいさめ	小さめ	稍小
ちがい	違い	不同
ちかう	誓う	发誓，宣誓
ちかく	知覚	知觉，感觉
ちかごろ	近頃	最近
ちかづく	近づく	靠近
ちかみち	近道	近道，近路
ちかよる	近寄る	接近，靠近
ちきゅう	地球	地球
ちきゅうじょう	地球上	地球上
ちこく	遅刻	迟到
ちしき	知識	知识
ちじょく	恥辱	耻辱
ちてん	地点	地点
ちのう	知能	智能
ちゃくちゃく	着々	一步一步，节节
ちゃんと		好好地
ちゅうおう	中央	中央
ちゅうかじんみんきょうわこく	中華人民共和国	中化人民共合国
ちゅうしゅつ	抽出	抽出，抽取
ちゅうしょうてき	抽象的	抽象
ちゅうしん	中心	中心
ちゅうねん	中年	中年
ちゅうぶ	中部	中部
ちゅうもん	注文	要，订货，订菜
チューリップ		郁金香
ちゅうりゅう	中流	中流，中游
ちょう	長	长，首领
ちょう	超	超~
ちょうこがた	超小型	超小型
ちょうてん	頂点	顶点
ちょうみりょう	調味料	调味料
ちょうめん	帳面	笔记本，账簿
ちょくせつ	直接	直接
ちょくせん	直線	直线
ちょさく	著作	著作
ちょっかん	直観	直观
ちょっとした		有点特别
ちょっぴり		稍稍，有点
ちらかす	散らかす	乱扔，弄乱
ちる	散る	谢，落
ちん	賃	~费
ついに		终于，终究
つうか	通貨	通货，流通的货币
つうじる	通じる	通过
つかいなれる	使い慣れる	用惯
つかいわける	使い分ける	分别使用
つかえる	支える	堵，塞
つかれ	疲れ	疲劳，疲倦
つき	月	月亮；月份，月
つき	付	带~
つきそう	付き添う	跟随，侍从，护理
つきとおす	突き通す	扎透，穿通
つく	付く	(気がつく)发现，注意到；感到~；带，具有
つぐなう	償う	赔偿，抵偿
つくりあげる	作り上げる	做成，完成
つくりばなし	作り話	编出来的话
つける	点ける	开(电灯)
つち	土	土
つつむ	包む	包，裹
つながり		联系
つぼ	壺	壶，罐，坛
つぼいちゅうじ	坪井忠二	坪井忠二
つまり		也就是
つみおろし	積み卸ろし	装卸
つみかさね	積み重ね	积累
つむ	積む	堆积，垒积
つめ	爪	指甲，趾甲
つめこむ	詰み込む	装满，塞满
つれもどす	連れ戻す	带回(人或动物)
てあらい	手洗い	洗手，厕所
ていき	提起	提出，提起
ていけつ	締結	缔结，签订
ていしゃば	停車場	停车场，车站
ていりゅうじょ	停留所	(公共汽车)车站
でかける	出掛ける	到……去，出去
てき	敵	敌，敌人
てき	的	~的
でき	出来	制成，作成
できあがり	出来上がり	做好
てきい	敵意	敌意
てきちゅう	的中	命中，准确
てきよう	適用	适用
デクエアル		德奎利亚尔
てごたえ	手応え	反应，效果
てごろ	手頃	合适，相当
デシリットル		分升
ですから		所以
てつ	鉄	铁
てづくり	手作り	亲手
てっする	徹する	彻，透
てつだい	手伝い	帮忙，帮忙的人
てってい	徹底	彻底，透彻
てつどう	鉄道	铁路
ではいり	出入り	出入
でむかえ	出迎え	来迎接
でむかえる	出迎える	迎接
てらす	照らす	照，照耀
テレビきょく	テレビ局	电视台
でんし	電子	电子
でんしかいろ	電子回路	电子电路
てんじょう	天井	天花板
てんずる	転ずる	转变，改变
てんとう	転倒	翻倒，跌倒
でんとうてき	伝統的	传统的
てんにょ	天女	仙女
てんねん	天然	天然，自然
てんめつ	点滅	忽亮忽灭
ど	度	~度
どあい	度合い	程度
とい	問い	问
どう	同	同~
とうかいどう	東海道	东海道
どうきゅうせい	同級生	同学
とうきょうはつ	東京発	由东京始发
どうけい	憧憬	憧憬，向往
とうじ	当時	当时
どうじ	同時	同时
どうしつ	同質	同一性质
とうしょ	当初	当初
とうしょ	投書	读者来信，投稿
とうしん	答申	回答咨询
どうせだい	同世代	同年代，同时代
とうちゃく	到着	到达
とうてん	読点	逗号
どうてん	動転	惊慌
どうにも		不管怎么也~
とうひ	当否	当否，是否正确
どうり	道理	道理
どうろ	道路	道路
とうわく	当惑	为难，困惑
とおす	通す	通过
とおりかかる	通り掛かる	路过
とかい	都会	城市
どかす	退かす	挪开，移开
とき	時	时，时候
とくい（だ）	得意	拿手，擅长
とくしつ	特質	特征，特性
どくしょ	読書	读书
とくてい	特定	特定
どける	退ける	挪开，移开
ところが		可是
ところで		不过，我说
とし	都市	城市，都市
とじこめる	閉じ込める	关在里面
としつき	年月	年月，岁月
としょ	図書	图书
としより	年寄り	老人
とじる	閉じる	关闭
としん	都心	市中心
とち	土地	地区
とっきゅうけん	特急券	特快票
とつぜん	突然	忽然，突然
とってかわる	取って代わる	取代
とどく	届く	送来，送到
とどろく		轰鸣，跳动
とにかく		无论如何
どのように		如何，怎样
とびおりる	飛び降りる	跳下
とびつく	飛び付く	扑过来，抢
とびのる	飛び乗る	跳上，乘上
とびまわる	飛び回る	飞翔
とめる	泊める	住宿，过夜
ともる	点る	点燃
ドライブ		开汽车郊游
トランジスタ		晶体管
とりかかる	取り掛かる	着手
とりはずし	取り外し	取下
とりはずす	取り外す	取下
どりょく	努力	努力
とる	捕る	捕捉
とる	採る	采集
トルコ		土耳其
どれほど		多么，怎样，怎么
とれる	取れる	收，出产
どんどん		接连不断
トンビ		鸢
ないせい	内省	反省
ないよう	内容	内容
なかでも	中でも	特别，尤其
ながねん	長年	长年，多年
ながびく	長引く	拖长，拖延
なかま	仲間	伙伴，同事
なかまいり	仲間入り	加入…的行列，列为…
ながめる	眺める	眺望，远眺
ながれる	流れる	流，播放
なし		梨
なぞなぞ		谜语，谜语游戏
なだめる	宥める	劝解，哄，安慰
なだらか		平缓，平稳
なつかしい	懐かしい	怀念
なにしろ		不管怎么说
なにぶん	何分	只是因为，无奈
なにより	何より	最好
なびく	靡く	随风摇摆，服从
なべ	鍋	锅
なみ	波	波，波浪
なみだ	涙	眼泪
なんといっても	何と言っても	首先，不论怎么说
なんとか		千方百计，设法
なんとなく	何と無く	似乎有点
にぎる	握る	握，抓
にぎわう		热闹
にこにこ		笑嘻嘻，笑眯眯
にしぐち	西口	西口
にじむ		渗，洇
にしんほう	二進法	二进制
にせ	偽	假，伪造
にちじ	日時	日期和时间
にちじょうさはんじ	日常茶飯事	家常便饭
にちようひん	日用品	日用品
にっし	日誌	日志，日记
にってい	日程	日程
にっすう	日数	天数
にほん	日本	日本
ニュージーランド		新西兰
にゅうじょう	入場	入场
にら	韮	韭菜
にんき	人気	(人)受欢迎，有人缘
にんげん	人間	人，人类
にんじん	人参	胡萝卜
にんたい	忍耐	忍耐
にんにく		大蒜
にんまえ	人前	~人的份
ぬう	縫う	缝
ぬく	抜く	拔掉，抽出
ぬぐう		擦，揩掉，消除
ぬの	布	布
ぬるい	温い	微温，温和
ぬれる	濡れる	淋湿
ね	根	根
ねえ		喂
ねがいごと	願い事	心愿，愿望
ねがう	願う	祝愿
ねぎ		葱
ねだる	強請る	强求，央求
ねだん	値段	价格
ねぶたまつり	ねぶた祭り	佞武多节
ねまき	寝間着	睡衣
ねんいり	念入り	周到，细致
ねんじゅう	年中	年中，一年间
ねんねん	年々	年年
の	野	原野，田野
のう	能	能(古典歌舞剧)
のうか	農家	农民，农户
のうきぐ	農機具	农机具
のうぎょう	農業	农业
のうみん	農民	农民
のうりつ	能率	效率
のき	軒	屋檐
のこす	残す	剩下
のこらず	残らず	全部，统统
のせる	乗せる	放，装载
のぞむ	望む	希望，指望
のぼる	昇る	升高，飞
のり		紫菜
のりおり	乗り降り	上下(车)
のりだす	乗り出す	探出
のんびり		悠闲，舒坦
わりきれる	割り切れる	除得尽
わな	罠	圈套
わたしたち		我们
わた	綿	棉花
わずか	僅か	仅仅，仅有
わしつ	和室	日本式房间
わざわい	災い	灾祸，灾难
わける	分ける	分，分开
わけ		原因，理由
わき	脇	腋
わかれる	分かれる	分歧
わかる	分かる	明白，懂
わがまま		任性，放肆
わかちがき	分かち書き	(为易读懂)把句节或词之间分开的写法
わがくに	わが国	我国
わか	和歌	和歌
ハーモニカ		口琴
はいえん	肺炎	肺炎
はいきぶつ	廃棄物	媒介，传播
ハイキング		郊游，徒步旅行
はいく	俳句	俳句
はいごう	配合	配合，配
はいぞく	配属	分配
ばいてん	売店	小卖部，小卖店
パイナップル		菠萝
バイバイ		再见
ハイヒール		高跟鞋
はいふく	拝復	(写回信的开头用语)敬复者
パイロット		飞机驾驶员
はか	墓	墓
ばか		傻瓜，笨蛋
はがす		剥下，揭下
はかせ	博士	博士
はかまいり	墓参り	扫墓
パキスタン		巴基斯坦
はきだす	吐き出す	吐出，冒出，倒出
はきもの	履物	鞋(类的总称)
はく	掃く	扫
はく	吐く	吐，冒出，吐露
はくさい	白菜	白菜
はくし	白紙	白纸
はくしゅ	拍手	拍手
はくしょ	白書	白皮书
ばくだい	莫大	巨大，莫大
はくちゅう	白昼	白昼，白天
ばくふ	幕府	幕府(日本早年的武士政权机构)
はくぶつかん	博物館	博物馆
はげしい	激しい	激烈，强烈
はこにわ	箱庭	庭园盆景
はこびちん	運び賃	运费
はさみ	鋏	剪子
はし	端	边，端
はし	箸	筷子
はじめ	始め	开始；起初，当初
はしもと	橋本	桥本(姓氏)
ばしょ	場所	场所，地方，地点
はしら	柱	柱子
パス		通过
はずす	外す	摘掉
はせがわ	長谷川	长谷川(姓氏)
パターン		型，类型
はたけ	畑	旱田，田地
はち	鉢	花盆
ばつ	罰	罚
はっけん	発見	发现
はっせいき	８世紀	8世纪
はったつ	発達	发达
はってん	発展	发展
はつでんき	発電機	发电机
はっぴょう	発表	发表
はつめい	発明	发明
はて	果て	边，边际，最后
バドミントン		羽毛球
はなしあい	話し合い	商谈
はなしあう	話し合う	互相谈论
はなして	話して	说话人
はなす	放す	撒开，松开
バナナ		香蕉
はなび	花火	烟火
はなれじま	離れ島	孤岛
はならばなれ	離れ離れ	分离，分散
はなれる	離れる	离开，离别
ははは		哈哈
はみだす	はみ出す	溢出，挤出
はめる		安上，嵌，镶
ばめん	場面	场面
はやし	林	林
はやめ	早め	早些，提前
はら	腹	肚子
はり	針	针，指针
はるかに		远，遥远
はれ	晴れ	晴，晴天
ハワイ		夏威夷
ばん	番	轮班，顺序
はんこう	反抗	反抗
バンコク		曼谷
ばんじ	万事	万事
はんせいきあまり	半世紀余り	半个多世纪
はんどう	反動	反动
はんどうたい	半導体	半导体
ハンバーグ		汉堡牛肉饼
ばんぶつ	万物	万物
ばんりのちょうじょう	万里の長城	万里长城
ひ	費	~费
ひあい	悲哀	悲哀
ひあたり	日当たり	向阳处
ピーアール（ＰＲ）		宣传
ピーマン		柿子椒
ビール		啤酒
ひがえり	日帰り	当天，返回
ひかくてき	比較的	比较
ひかげ	日陰	背阴处
ひかり	光	光
ひかりごう	ひかり号	光号
ひかる	光る	发光，发亮
ひきうける	引き受ける	接受，承担
ひきかえ	引き替え	交换
ひきかえす	引き返す	返回，折回
ひきかえる	引き換える	换，交换，兑换
ひきさがる	引き下がる	撒手，罢休
ひきしめる	引き締める	勒紧，抓紧，紧缩
ひきだす	引き出す	拉出，抽出
ひきとめる	引き止める	挽留
ひきのばす	引き伸ばす	拉长，拖延
ひきわけ	引き分け	拉开，平局
ひぐれ	日暮れ	日暮，黄昏
ひげき	悲劇	悲剧
びこう	備考	备考，备注
ひこく	被告	被告
ビザ		签证
びしょう	微小	极少，微小
ひじょう	非常	非常，极，很
ひたん	悲嘆	悲叹
ひつう	悲痛	悲痛
ひっかかる	引っ掛かる	挂上，卡住
ひっかける	引っ掛ける	挂上，挂起来
びっくり		吃惊
ひっくりかえる	引っ繰り返る	倒，翻倒
ひっこむ	引っ込む	退居，缩进
ひっし	必至	必然到来
ひっしゃ	筆者	笔者，作者
ひつじゅひん	必需品	必需品
ひっぱる	引っ張る	拉，拽
ひどい	酷い	厉害，残酷，无情
ひとえ	一重	一层
ひときわ	一際	格外，显眼
ひとこと	一言	几句话
ひとしい	等しい	相同，相等
ひとで	人手	他人，帮手
ひととおり	一通り	大概，大略
ひとなみ	人並み	普通，平常
ひとまとめ	一まとめ	归纳，总括
ひとまわり	一回り	一周，一圈
ひとみ	瞳	瞳孔
ひとりごと	独り言	自言自语
ひとりでに	独りでに	自然而然
ひなまつり	ひな祭り	女儿节
ビニール		乙烯树脂，塑料
ひにち	日にち	日期，时日
ひび		裂口，裂痕
ひやくてき	飛躍的	飞跃
ひゃくパーセント	100%	百分之百
ひやす	冷やす	凉一凉，冰镇
ひゃっかじてん	百科事典	百科全书
ひゃっかてん	百貨店	百货商店
ひややか	冷ややか	凉，冷，冷淡，冷静
ひゆ	比喩	比喻
びょう	秒	秒，秒钟；~秒
びょう	鋲	图钉
ひょうご	標語	标语
ひょうし	拍子	拍子
ひょうじゅん	標準	标准
ひょうばん	評判	名声，评价
ひょうめい	表明	表明
ひょうろん	評論	评论
ひよく	肥沃	肥沃
ビリヤード		台球
ひるね	昼寝	午睡
ひるむ		畏怯，胆怯
ひろう	披露	表演，宣布
ひろがる	広がる	扩展
ひろさ	広さ	宽度，面积
ひろば	広場	广场
ひろびろ	広広	辽阔，宽广
ひん	品	~品
ふ	府	府，机关
ふ	不	不~
ファクシミリ		传真
ふうう	風雨	风雨
ふうせん	風船	气球
ふうん		噢
ふえつづける	増え続ける	继续增加
ふかのう	不可能	不可能
ふかめ	深め	加深
ふきげん	不機嫌	不愉快，不高兴
ふきそく	不規則	不规则，零乱
ふきだす	吹き出す	笑出声
ぶきみ	無気味	令人不快
ふきゅう	普及	普及
ふきよう	不器用	笨，笨拙
ふく	拭く	擦
ふくしょく	服飾	服饰
ふくすう	複数	复数
ふくそう	服装	服装
ふくむ	含む	包含，含有
ふくろ	袋	口袋，袋
ふけい	父兄	父兄
ふけつ	不潔	不干净，脏
ふさい	夫妻	夫妻
ぶし	武士	武士
ぶじ	無事	没事
ふしぎ（だ）	不思議	不可思议
ふしぜん	不自然	不自然，勉强
ぶしゅ	部首	部首
ふじん	婦人	妇女
ふせい	不正	不正经，不正派
ふせる	伏せる	隐藏，埋伏
ふそく	不足	不足，缺少
ふたたび	再び	再，又，重
ふだんぎ	普段着	便服
ぶつかる		碰撞
ふっき	復帰	恢复，复职，复原
ぶっしつ	物質	物质
ぶっぴん	物品	物品，物件
ぶつり	物理	物理
ふなびん	船便	船运邮件
ふひつよう	不必要	不必要
ふぶき	吹雪	暴风雪
ぶぶん	部分	部分，一部分
ふへん	不変	不变，永恒
ふへんてき	普遍的	普遍
ふもと	麓	山脚
ふよう	不要	不要，不需要
ぶらつく		摇摇晃晃，摇摇摆摆
ふりかける	振り掛ける	撒上
ふりがな	振り仮名	注音假名
ふりだす	降り出す	下起
ふりつづく	降り続く	连续下(雨或雪)
ふりょうひん	不良品	次品，不合格产品
ふる	振る	挥动
ふるさと	故郷	故乡
ふろ	風呂	澡盆，浴池
プロ		职业的，专业的
ふろく	付録	附录
プロレタリア		无产者，无产阶级
ふん	分	~分
ふんか	噴火	(火山)喷发
ぶんか	分化	分化
ぶんげい	文芸	文艺
ぶんけん	文献	文献
ぶんしょう	文章	文章
ぶんみゃく	文脈	文理
ぶんりょう	分量	分量，重量
へい	丙	丙
へいかい	閉会	闭会
へいき	平気	不在乎，镇静
へいじつ	平日	平日，平素
へいてん	閉店	关门，停止营业
へいぼん	平凡	平凡，普通
へいわ	平和	和平
へえ		嘿
ページ		页
へだてる	隔てる	隔，间隔
べっきょ	別居	分居
べつに	別に	另外，除此以外
べつびん	別便	另函，另寄
べにしょうが	紅生姜	红姜
ヘリコプター		直升飞机
へる	減る	减少
べん	便	便利，方便
ぺん		笔，钢笔
へんか	変化	变化
べんがく	勉学	勤学，读书
べんきょういがい	勉強以外	除了学习以外
べんぎをはかる	便宜を図る	提供方便
べんとう	弁当	盒饭
ぼう	棒	棒
ほうい	方位	方位，方向
ほうがく	方角	方位，方向
ほうかご	放課後	放学后
ほうこく	報告	汇报，报告
ぼうじょ	防除	防治，防除
ぼうだい	膨大	庞大
ほうふ	抱負	抱负
ほうほう	方法	方法
ほうめん	方面	方面
ほうもんぎ	訪問着	会客和服
ほうもんちゅう	訪問中	正在访问中
ぼうりょく	暴力	暴力
ボーリング		地滚球游戏
ボールがみ	ボール紙	纸板，厚纸
ほか	他	以外
ぼかす	暈す	晕色，烘托
ぼく		我(男人对同辈或晚辈用)
ほくせい	北西	西北
ぼくたち		我们
ほくぶ	北部	北部
ほこ	矛	矛
ほこり	埃	灰尘，尘土
ほころびる		绽线，开线
ほす	干す	晒，晾
ポスター		招贴画，广告画
ポスト		邮筒，信箱
ほっきょく	北極	北极
ほったん	発端	开端，开始，起源
ほとけ	仏	佛
ほのぼの		模糊，朦胧
ほら		瞧
ほる	掘る	挖，掘
ほろぶ	滅ぶ	灭亡，灭绝
ぼんさい	盆栽	盆景
ほんじつ	本日	本日，今天
ぼんち	盆地	盆地
ほんにん	本人	本人
まあまあ		得了，好了
まいあがる	舞い上がる	飞起
まがる	曲がる	拐弯
まぎらす	紛らす	蒙混，掩饰
まぎわ	間際	将要~的时候
まく	巻く	卷，卷起，拧
まくる		卷，卷起，挽
まげる	曲げる	弯曲
まご	孫	孙子，孙女，外孙子，外孙女
ます	升	升，斗形
ます	増す	增加
まずしい		贫穷
ますます		越来越~
まぜあわせる	混ぜ合わせる	掺混搅拌
まぜる	混ぜる	混，掺混
またぐ		迈过，跨过
まだまだ		还
まだら		斑点，花斑
まちあいしつ	待合室	候诊室
まちがう	間違う	错，弄错
まちなみ	町並み	街道
まっしろ	真っ白	雪白
まつまと	松本	松本(姓氏)
まつる	祭る	祭祀
まつわる		相关，关联
マティ		马迪
まどガラス	窓ガラス	玻璃窗
まなぶ	学ぶ	学，学习
まね	真似	学，装，模仿
まぶた		眼皮，眼睑
まふゆ	真冬	严冬，隆冬
まほう	魔法	魔术，妖术
まめ	豆	豆
まもなく	間も無く	不久，不一会儿
まもる	守る	恪守，遵守
もよう	迷う	犹豫不决
マラソン		马拉松
マルクス		马克思
まるで		简直
まるやまこうえん	円山公園	圆山公园
まわす	回す	转，旋转
まんいん	満員	客满，拥挤
まんぞく（する）	満足	满足，满意
まんなか	真ん中	正中
み	実	果实
みうしなう	見失う	看不到，迷失
みおくる	見送る	送行
みかた	見方	己方，同伙，伙伴
みかん		桔子
みきわめる	見極める	看清，看透
みくらべる	見比べる	比较
みじん		微量，微小
みずあび	水浴び	洗澡，淋浴
みずみずしい		新鲜，娇嫩
みぜん	未然	未然，未发生前
みだし	見出し	标题
みため	見た目	外观
みだり		擅自，随便
みちじゅん	道順	路线，顺序
みちすじ	道筋	道路，路线，条理
みとめる	認める	承认，同意
みなおす	見直す	重看，重新认识
みなれる	見慣れる	看惯
みまもる	見守る	关怀，照料
みまわす	見回す	环视
みやげばなし	みやげ話	旅途见闻
みやこ	都	首都，都城
みらい	未来	未来
ミリ		~毫
ミリグラム		~毫克
ミリメートル		~毫米
みりょく	魅力	魅力，吸引力
ミリリットル		~毫升
みんしゅ	民主	民主
みんしゅう	民衆	民众
みんぞくだいいどう	民族大移動	民族大迁移
むいしき	無意識	无意识
むかう	向かう	向，对
むく	向く	适合
むく	剥く	剥，削
むくいる	報いる	酬谢，报答
むける	向ける	向，朝
むごい	惨い	悲惨，残酷
むざん	無残	凄惨，残酷
むじゅん	矛盾	矛盾
むしん	無心	无心，天真
むすぶ	結ぶ	连接
むだ	無駄	浪费，白费
むちゅう	夢中	热中于~，着迷
むね	胸	胸膛
むやみ		胡乱，随便
むら		(颜色)深浅不均，斑点
むらさき	紫	紫色
むりょう	無料	免费，不要钱
むれ	群れ	一伙，一帮，群
むろまち	室町	室町
め	芽	芽
め		第~
めいわく	迷惑	觉得麻烦，为难
メーデー		五一国际劳动节
めし	飯	饭，主食
めした	目下	部下，下级，晚辈
めじるし	目印	记号，标记
メス		雌，牝，母
めだつ	目立つ	引人注目
めでたい		可喜，可贺
めど		目标，眉头，头绪
メニュー		菜单
めやす	目安	基准
メロン		甜瓜，网纹甜瓜
めん	面	方面
めんせき	面積	面积
めんどう	面倒	麻烦
メンバー		成员，分子
もうら	網羅	罗网，收罗
もえあがる	燃え上がる	燃烧起
もえる	燃える	燃烧，着火
モーターボート		汽艇，快速艇
もくざい	木材	木材
もくじ	目次	目录，目次
もくてき	目的	目的
もじ	文字	文字
もたれる		凭靠，不消化
もちいる	用いる	使用，用
もちだす	持ち出す	拿出去
もっか	目下	目前，当前
もっとも	最も	最
もと	元	原来
もとめる	求める	追求
もとより		本来，原来
もの	者	人，者
もみじ	紅葉	红叶
もも	桃	桃
もも	腿	大腿
もよう	模様	花样，花纹
もり	森	树林，森林
もりこむ	盛り込む	加进
もりつける	盛り付ける	把饭菜很好地盛在器皿上
やがて		不久
やかましい		吵闹，嘈杂
やきもの	焼き物	陶瓷
やく	役	职务，角色
やく	約	大约
やくご	訳語	译词
やくしゃ	役者	演员
やくだつ	役立つ	有用，有益
やくだてる	役立てる	使用，用于
やくめ	役目	作用
やすやす		容易，轻易
やすらか	安らか	安稳，安静
やせる	痩せる	瘦
やたら		任意，胡乱，过分
やちん	家賃	房租
やっき		着急，急躁
やね	屋根	屋顶，房顶
やぶれる	敗れる	败，败北
やぶれる	破れる	破，裂，破灭
やまい	病	病
やまくち	山口	山口
やまざき	山崎	山崎
やまと	大和	大和
やまやま	山々	群山
やむ	止む	(雨)停
やら		表示不确定，列举
やりとり		相互，交替
ゆうえんち	遊園地	娱乐场
ゆうかん	夕刊	晚报
ゆうき	勇気	勇气
ゆうげん	有限	有限
ユーゴスラビア		南斯拉夫
ゆうじょう	友情	友情，友谊
ゆうしょく	夕食	晚饭
ゆうじん	友人	朋友
ゆうちょう	悠長	悠闲，稳静
ゆかい	愉快	愉快，有趣
ゆきき	行き来	往来，交往
ゆく	逝く	流逝，经过
ゆけつ	輸血	输血
ゆする	揺する	摇动，摇晃
ゆだねる	委ねる	委托，献(身)
ゆだん	油断	麻痹，疏忽
ゆにゅう	輸入	输入，进口
ゆめみる	夢見る	做梦，梦见
ゆらい	由来	来历，由来
ゆるす	許す	允许，同意
ようがん	溶岩	熔岩
ようきゅう	要求	要求
ようぐ	用具	用具，工具
ようじ	幼児	幼儿
ようしつ	洋室	西式房间
ようす	様子	样子，情况
ようすこう	揚子江	长江
ようび	曜日	星期
ようやく	要約	要点，概要
ようやく	漸く	终于，总算
ようれい	用例	用例
ヨーロッパ		欧洲
よくばる	欲張る	贪婪
よくよく	翼翼	小心翼翼
よこたわる	横たわる	躺卧，横放
よせる	寄せる	移近，召集，寄居
よのなか	世の中	世间，社会
よぼう	予防	预防
よほうかん	予報官	预报员
よほど		相当，十分
よみて	読み手	读的人
よみとる	読み取る	理解
よる	因る	根据，按照
よわむす	弱虫	懦夫
ら		~们
ライトきょうだい	ライト兄弟	莱特兄弟
らいにち	来日	来日，来到日本
らく（だ）	楽	轻松，舒适
らくだい	落第	不及格
らくらく	楽々	舒服，安适，快乐
ラジカセ		收录机
らん	欄	栏
りか	理科	理科(自然、化学、物理等)
りかい	理解	理解
りがい	利害	利害，利弊
りく	陸	陆地
りすうけい	理数系	理科和数学，物理专业
りそう	理想	理想
りち	理知	理智
りっきゃく	立脚	立足，根据
りっぱ	立派	杰出，优秀
りねん	理念	理念，理性
リボン		丝带，缎带
りゅうい	留意	留心，注意
りゅうがく（する）	留学	留学
りゅうこう	流行	流行
りゅうどう	流動	流动
りょう	寮	宿舍
りょう	猟	猎，狩猎
りょう	量	量；~量
りょうじ	領事	领事
りょうよう	療養	疗养
りょかっき	旅客機	客机
りりく	離陸	离地，起飞
るいけい	類型	类型
るすばん	留守番	看门
ルネサンス		文艺复兴
れい	例	例子，例
れい	礼	道谢，行礼
レーダー		雷达
レオナルド·ダ·ビンチ		列奥纳多·达·芬奇
レクリエーション		娱乐(活动)
れっとう	列島	列岛，群岛
れんこん		藕
れんそう	連想	联想
ろう	老	老~
ろうか	廊下	走廊
ろうどう	労働	劳动
ろうねん	老年	老年
ろうばい		狼狈
ろうふうふ	老夫婦	老年夫妇
ローマ		罗马
ろくおん	録音	录音
ロケット		火箭
ろんきょ	論拠	论据
ろんしょう	論証	论证
ろんせつ	論説	评论，社论
ロンドン		伦敦
なんぼく	南北	南北
